"filename", "language", "XML", "Batch", "Markdown", "Java", "Java Properties", "comment", "blank", "total"
"c:\workspace\research\papers\2024\JISBD2024-JAParejo\llms-design-patterns-evaluation\oodp-scenarios\.mvn\wrapper\MavenWrapperDownloader.java", "Java", 0, 0, 0, 76, 0, 31, 11, 118
"c:\workspace\research\papers\2024\JISBD2024-JAParejo\llms-design-patterns-evaluation\oodp-scenarios\.mvn\wrapper\maven-wrapper.properties", "Java Properties", 0, 0, 0, 0, 2, 0, 1, 3
"c:\workspace\research\papers\2024\JISBD2024-JAParejo\llms-design-patterns-evaluation\oodp-scenarios\behavioural\command\command-e1\.mvn\wrapper\MavenWrapperDownloader.java", "Java", 0, 0, 0, 76, 0, 31, 11, 118
"c:\workspace\research\papers\2024\JISBD2024-JAParejo\llms-design-patterns-evaluation\oodp-scenarios\behavioural\command\command-e1\.mvn\wrapper\maven-wrapper.properties", "Java Properties", 0, 0, 0, 0, 2, 0, 1, 3
"c:\workspace\research\papers\2024\JISBD2024-JAParejo\llms-design-patterns-evaluation\oodp-scenarios\behavioural\command\command-e1\mvnw.cmd", "Batch", 0, 68, 0, 0, 0, 45, 32, 145
"c:\workspace\research\papers\2024\JISBD2024-JAParejo\llms-design-patterns-evaluation\oodp-scenarios\behavioural\command\command-e1\pom.xml", "XML", 13, 0, 0, 0, 0, 0, 4, 17
"c:\workspace\research\papers\2024\JISBD2024-JAParejo\llms-design-patterns-evaluation\oodp-scenarios\behavioural\command\command-e1\runs\run1.md", "Markdown", 0, 0, 261, 0, 0, 0, 69, 330
"c:\workspace\research\papers\2024\JISBD2024-JAParejo\llms-design-patterns-evaluation\oodp-scenarios\behavioural\command\command-e1\runs\run2.md", "Markdown", 0, 0, 347, 0, 0, 0, 100, 447
"c:\workspace\research\papers\2024\JISBD2024-JAParejo\llms-design-patterns-evaluation\oodp-scenarios\behavioural\command\command-e1\src\main\java\original\Editor.java", "Java", 0, 0, 0, 88, 0, 0, 14, 102
"c:\workspace\research\papers\2024\JISBD2024-JAParejo\llms-design-patterns-evaluation\oodp-scenarios\behavioural\command\command-e1\src\main\java\run1\Command.java", "Java", 0, 0, 0, 5, 0, 0, 2, 7
"c:\workspace\research\papers\2024\JISBD2024-JAParejo\llms-design-patterns-evaluation\oodp-scenarios\behavioural\command\command-e1\src\main\java\run1\CommandHistory.java", "Java", 0, 0, 0, 25, 0, 0, 6, 31
"c:\workspace\research\papers\2024\JISBD2024-JAParejo\llms-design-patterns-evaluation\oodp-scenarios\behavioural\command\command-e1\src\main\java\run1\CopyCommand.java", "Java", 0, 0, 0, 14, 0, 1, 7, 22
"c:\workspace\research\papers\2024\JISBD2024-JAParejo\llms-design-patterns-evaluation\oodp-scenarios\behavioural\command\command-e1\src\main\java\run1\CutCommand.java", "Java", 0, 0, 0, 25, 0, 0, 8, 33
"c:\workspace\research\papers\2024\JISBD2024-JAParejo\llms-design-patterns-evaluation\oodp-scenarios\behavioural\command\command-e1\src\main\java\run1\Editor.java", "Java", 0, 0, 0, 53, 0, 0, 13, 66
"c:\workspace\research\papers\2024\JISBD2024-JAParejo\llms-design-patterns-evaluation\oodp-scenarios\behavioural\command\command-e1\src\main\java\run1\PasteCommand.java", "Java", 0, 0, 0, 19, 0, 0, 6, 25
"c:\workspace\research\papers\2024\JISBD2024-JAParejo\llms-design-patterns-evaluation\oodp-scenarios\behavioural\command\command-e1\src\main\java\run2\Command.java", "Java", 0, 0, 0, 5, 0, 0, 2, 7
"c:\workspace\research\papers\2024\JISBD2024-JAParejo\llms-design-patterns-evaluation\oodp-scenarios\behavioural\command\command-e1\src\main\java\run2\CopyCommand.java", "Java", 0, 0, 0, 14, 0, 1, 6, 21
"c:\workspace\research\papers\2024\JISBD2024-JAParejo\llms-design-patterns-evaluation\oodp-scenarios\behavioural\command\command-e1\src\main\java\run2\CutCommand.java", "Java", 0, 0, 0, 29, 0, 0, 6, 35
"c:\workspace\research\papers\2024\JISBD2024-JAParejo\llms-design-patterns-evaluation\oodp-scenarios\behavioural\command\command-e1\src\main\java\run2\Editor.java", "Java", 0, 0, 0, 73, 0, 2, 18, 93
"c:\workspace\research\papers\2024\JISBD2024-JAParejo\llms-design-patterns-evaluation\oodp-scenarios\behavioural\command\command-e1\src\main\java\run2\PasteCommand.java", "Java", 0, 0, 0, 18, 0, 0, 5, 23
"c:\workspace\research\papers\2024\JISBD2024-JAParejo\llms-design-patterns-evaluation\oodp-scenarios\behavioural\command\command-e1\target\classes\original\Editor$1.class", "Java", 0, 0, 0, 9, 0, 0, 0, 9
"c:\workspace\research\papers\2024\JISBD2024-JAParejo\llms-design-patterns-evaluation\oodp-scenarios\behavioural\command\command-e1\target\classes\original\Editor$2.class", "Java", 0, 0, 0, 18, 0, 0, 0, 18
"c:\workspace\research\papers\2024\JISBD2024-JAParejo\llms-design-patterns-evaluation\oodp-scenarios\behavioural\command\command-e1\target\classes\original\Editor$3.class", "Java", 0, 0, 0, 12, 0, 0, 0, 12
"c:\workspace\research\papers\2024\JISBD2024-JAParejo\llms-design-patterns-evaluation\oodp-scenarios\behavioural\command\command-e1\target\classes\original\Editor$4.class", "Java", 0, 0, 0, 18, 0, 0, 0, 18
"c:\workspace\research\papers\2024\JISBD2024-JAParejo\llms-design-patterns-evaluation\oodp-scenarios\behavioural\command\command-e1\target\classes\original\Editor.class", "Java", 0, 0, 0, 38, 0, 0, 0, 38
"c:\workspace\research\papers\2024\JISBD2024-JAParejo\llms-design-patterns-evaluation\oodp-scenarios\behavioural\command\command-e1\target\classes\run1\Command.class", "Java", 0, 0, 0, 3, 0, 0, 0, 3
"c:\workspace\research\papers\2024\JISBD2024-JAParejo\llms-design-patterns-evaluation\oodp-scenarios\behavioural\command\command-e1\target\classes\run1\CommandHistory.class", "Java", 0, 0, 0, 19, 0, 0, 0, 19
"c:\workspace\research\papers\2024\JISBD2024-JAParejo\llms-design-patterns-evaluation\oodp-scenarios\behavioural\command\command-e1\target\classes\run1\CopyCommand.class", "Java", 0, 0, 0, 12, 0, 0, 0, 12
"c:\workspace\research\papers\2024\JISBD2024-JAParejo\llms-design-patterns-evaluation\oodp-scenarios\behavioural\command\command-e1\target\classes\run1\CutCommand.class", "Java", 0, 0, 0, 29, 0, 0, 0, 29
"c:\workspace\research\papers\2024\JISBD2024-JAParejo\llms-design-patterns-evaluation\oodp-scenarios\behavioural\command\command-e1\target\classes\run1\Editor.class", "Java", 0, 0, 0, 62, 0, 18, 0, 80
"c:\workspace\research\papers\2024\JISBD2024-JAParejo\llms-design-patterns-evaluation\oodp-scenarios\behavioural\command\command-e1\target\classes\run1\PasteCommand.class", "Java", 0, 0, 0, 20, 0, 0, 0, 20
"c:\workspace\research\papers\2024\JISBD2024-JAParejo\llms-design-patterns-evaluation\oodp-scenarios\behavioural\command\command-e1\target\classes\run2\Command.class", "Java", 0, 0, 0, 3, 0, 0, 0, 3
"c:\workspace\research\papers\2024\JISBD2024-JAParejo\llms-design-patterns-evaluation\oodp-scenarios\behavioural\command\command-e1\target\classes\run2\CopyCommand.class", "Java", 0, 0, 0, 12, 0, 0, 0, 12
"c:\workspace\research\papers\2024\JISBD2024-JAParejo\llms-design-patterns-evaluation\oodp-scenarios\behavioural\command\command-e1\target\classes\run2\CutCommand.class", "Java", 0, 0, 0, 21, 0, 7, 0, 28
"c:\workspace\research\papers\2024\JISBD2024-JAParejo\llms-design-patterns-evaluation\oodp-scenarios\behavioural\command\command-e1\target\classes\run2\Editor.class", "Java", 0, 0, 0, 73, 0, 0, 0, 73
"c:\workspace\research\papers\2024\JISBD2024-JAParejo\llms-design-patterns-evaluation\oodp-scenarios\behavioural\command\command-e1\target\classes\run2\PasteCommand.class", "Java", 0, 0, 0, 19, 0, 0, 0, 19
"c:\workspace\research\papers\2024\JISBD2024-JAParejo\llms-design-patterns-evaluation\oodp-scenarios\behavioural\command\command-e1\target\maven-archiver\pom.properties", "Java Properties", 0, 0, 0, 0, 3, 2, 1, 6
"c:\workspace\research\papers\2024\JISBD2024-JAParejo\llms-design-patterns-evaluation\oodp-scenarios\behavioural\command\command-e2\.mvn\wrapper\MavenWrapperDownloader.java", "Java", 0, 0, 0, 76, 0, 31, 11, 118
"c:\workspace\research\papers\2024\JISBD2024-JAParejo\llms-design-patterns-evaluation\oodp-scenarios\behavioural\command\command-e2\.mvn\wrapper\maven-wrapper.properties", "Java Properties", 0, 0, 0, 0, 2, 0, 1, 3
"c:\workspace\research\papers\2024\JISBD2024-JAParejo\llms-design-patterns-evaluation\oodp-scenarios\behavioural\command\command-e2\mvnw.cmd", "Batch", 0, 68, 0, 0, 0, 45, 32, 145
"c:\workspace\research\papers\2024\JISBD2024-JAParejo\llms-design-patterns-evaluation\oodp-scenarios\behavioural\command\command-e2\pom.xml", "XML", 19, 0, 0, 0, 0, 0, 3, 22
"c:\workspace\research\papers\2024\JISBD2024-JAParejo\llms-design-patterns-evaluation\oodp-scenarios\behavioural\command\command-e2\runs\run1.md", "Markdown", 0, 0, 256, 0, 0, 0, 111, 367
"c:\workspace\research\papers\2024\JISBD2024-JAParejo\llms-design-patterns-evaluation\oodp-scenarios\behavioural\command\command-e2\runs\run2.md", "Markdown", 0, 0, 191, 0, 0, 0, 74, 265
"c:\workspace\research\papers\2024\JISBD2024-JAParejo\llms-design-patterns-evaluation\oodp-scenarios\behavioural\command\command-e2\src\main\java\original\Device.java", "Java", 0, 0, 0, 5, 0, 0, 4, 9
"c:\workspace\research\papers\2024\JISBD2024-JAParejo\llms-design-patterns-evaluation\oodp-scenarios\behavioural\command\command-e2\src\main\java\original\Stereo.java", "Java", 0, 0, 0, 14, 0, 0, 4, 18
"c:\workspace\research\papers\2024\JISBD2024-JAParejo\llms-design-patterns-evaluation\oodp-scenarios\behavioural\command\command-e2\src\main\java\original\TV.java", "Java", 0, 0, 0, 17, 0, 0, 6, 23
"c:\workspace\research\papers\2024\JISBD2024-JAParejo\llms-design-patterns-evaluation\oodp-scenarios\behavioural\command\command-e2\src\main\java\run1\AdjustVolumeCommand.java", "Java", 0, 0, 0, 18, 0, 0, 5, 23
"c:\workspace\research\papers\2024\JISBD2024-JAParejo\llms-design-patterns-evaluation\oodp-scenarios\behavioural\command\command-e2\src\main\java\run1\ChangeChannelCommand.java", "Java", 0, 0, 0, 12, 0, 0, 4, 16
"c:\workspace\research\papers\2024\JISBD2024-JAParejo\llms-design-patterns-evaluation\oodp-scenarios\behavioural\command\command-e2\src\main\java\run1\Command.java", "Java", 0, 0, 0, 4, 0, 0, 2, 6
"c:\workspace\research\papers\2024\JISBD2024-JAParejo\llms-design-patterns-evaluation\oodp-scenarios\behavioural\command\command-e2\src\main\java\run1\Main.java", "Java", 0, 0, 0, 22, 0, 3, 9, 34
"c:\workspace\research\papers\2024\JISBD2024-JAParejo\llms-design-patterns-evaluation\oodp-scenarios\behavioural\command\command-e2\src\main\java\run1\Main2.java", "Java", 0, 0, 0, 23, 0, 5, 10, 38
"c:\workspace\research\papers\2024\JISBD2024-JAParejo\llms-design-patterns-evaluation\oodp-scenarios\behavioural\command\command-e2\src\main\java\run1\RemoteControl.java", "Java", 0, 0, 0, 19, 0, 1, 7, 27
"c:\workspace\research\papers\2024\JISBD2024-JAParejo\llms-design-patterns-evaluation\oodp-scenarios\behavioural\command\command-e2\src\main\java\run1\RemoteControl2.java", "Java", 0, 0, 0, 17, 0, 0, 6, 23
"c:\workspace\research\papers\2024\JISBD2024-JAParejo\llms-design-patterns-evaluation\oodp-scenarios\behavioural\command\command-e2\src\main\java\run1\RemoteControlDemo.java", "Java", 0, 0, 0, 31, 0, 4, 9, 44
"c:\workspace\research\papers\2024\JISBD2024-JAParejo\llms-design-patterns-evaluation\oodp-scenarios\behavioural\command\command-e2\src\main\java\run1\TurnOffCommand.java", "Java", 0, 0, 0, 12, 0, 0, 5, 17
"c:\workspace\research\papers\2024\JISBD2024-JAParejo\llms-design-patterns-evaluation\oodp-scenarios\behavioural\command\command-e2\src\main\java\run1\TurnOnCommand.java", "Java", 0, 0, 0, 12, 0, 0, 5, 17
"c:\workspace\research\papers\2024\JISBD2024-JAParejo\llms-design-patterns-evaluation\oodp-scenarios\behavioural\command\command-e2\src\main\java\run2\Command.java", "Java", 0, 0, 0, 4, 0, 0, 2, 6
"c:\workspace\research\papers\2024\JISBD2024-JAParejo\llms-design-patterns-evaluation\oodp-scenarios\behavioural\command\command-e2\src\main\java\run2\RemoteControl.java", "Java", 0, 0, 0, 10, 0, 2, 4, 16
"c:\workspace\research\papers\2024\JISBD2024-JAParejo\llms-design-patterns-evaluation\oodp-scenarios\behavioural\command\command-e2\src\main\java\run2\RemoteControlTest.java", "Java", 0, 0, 0, 23, 0, 4, 6, 33
"c:\workspace\research\papers\2024\JISBD2024-JAParejo\llms-design-patterns-evaluation\oodp-scenarios\behavioural\command\command-e2\src\main\java\run2\TurnOffCommand.java", "Java", 0, 0, 0, 12, 0, 0, 5, 17
"c:\workspace\research\papers\2024\JISBD2024-JAParejo\llms-design-patterns-evaluation\oodp-scenarios\behavioural\command\command-e2\src\main\java\run2\TurnOnCommand.java", "Java", 0, 0, 0, 12, 0, 0, 5, 17
"c:\workspace\research\papers\2024\JISBD2024-JAParejo\llms-design-patterns-evaluation\oodp-scenarios\behavioural\command\command-e2\target\classes\original\Device.class", "Java", 0, 0, 0, 3, 0, 0, 0, 3
"c:\workspace\research\papers\2024\JISBD2024-JAParejo\llms-design-patterns-evaluation\oodp-scenarios\behavioural\command\command-e2\target\classes\original\Stereo.class", "Java", 0, 0, 0, 12, 0, 0, 0, 12
"c:\workspace\research\papers\2024\JISBD2024-JAParejo\llms-design-patterns-evaluation\oodp-scenarios\behavioural\command\command-e2\target\classes\original\TV.class", "Java", 0, 0, 0, 14, 0, 0, 0, 14
"c:\workspace\research\papers\2024\JISBD2024-JAParejo\llms-design-patterns-evaluation\oodp-scenarios\behavioural\command\command-e2\target\classes\run1\AdjustVolumeCommand.class", "Java", 0, 0, 0, 16, 0, 0, 0, 16
"c:\workspace\research\papers\2024\JISBD2024-JAParejo\llms-design-patterns-evaluation\oodp-scenarios\behavioural\command\command-e2\target\classes\run1\ChangeChannelCommand.class", "Java", 0, 0, 0, 13, 0, 0, 0, 13
"c:\workspace\research\papers\2024\JISBD2024-JAParejo\llms-design-patterns-evaluation\oodp-scenarios\behavioural\command\command-e2\target\classes\run1\Command.class", "Java", 0, 0, 0, 2, 0, 0, 0, 2
"c:\workspace\research\papers\2024\JISBD2024-JAParejo\llms-design-patterns-evaluation\oodp-scenarios\behavioural\command\command-e2\target\classes\run1\Main.class", "Java", 0, 0, 0, 14, 0, 0, 1, 15
"c:\workspace\research\papers\2024\JISBD2024-JAParejo\llms-design-patterns-evaluation\oodp-scenarios\behavioural\command\command-e2\target\classes\run1\Main2.class", "Java", 0, 0, 0, 22, 0, 0, 0, 22
"c:\workspace\research\papers\2024\JISBD2024-JAParejo\llms-design-patterns-evaluation\oodp-scenarios\behavioural\command\command-e2\target\classes\run1\RemoteControl.class", "Java", 0, 0, 0, 16, 0, 0, 0, 16
"c:\workspace\research\papers\2024\JISBD2024-JAParejo\llms-design-patterns-evaluation\oodp-scenarios\behavioural\command\command-e2\target\classes\run1\RemoteControl2.class", "Java", 0, 0, 0, 22, 0, 0, 0, 22
"c:\workspace\research\papers\2024\JISBD2024-JAParejo\llms-design-patterns-evaluation\oodp-scenarios\behavioural\command\command-e2\target\classes\run1\RemoteControlDemo.class", "Java", 0, 0, 0, 14, 0, 0, 1, 15
"c:\workspace\research\papers\2024\JISBD2024-JAParejo\llms-design-patterns-evaluation\oodp-scenarios\behavioural\command\command-e2\target\classes\run1\TurnOffCommand.class", "Java", 0, 0, 0, 12, 0, 0, 0, 12
"c:\workspace\research\papers\2024\JISBD2024-JAParejo\llms-design-patterns-evaluation\oodp-scenarios\behavioural\command\command-e2\target\classes\run1\TurnOnCommand.class", "Java", 0, 0, 0, 12, 0, 0, 0, 12
"c:\workspace\research\papers\2024\JISBD2024-JAParejo\llms-design-patterns-evaluation\oodp-scenarios\behavioural\command\command-e2\target\classes\run2\Command.class", "Java", 0, 0, 0, 2, 0, 0, 0, 2
"c:\workspace\research\papers\2024\JISBD2024-JAParejo\llms-design-patterns-evaluation\oodp-scenarios\behavioural\command\command-e2\target\classes\run2\RemoteControl.class", "Java", 0, 0, 0, 11, 0, 0, 0, 11
"c:\workspace\research\papers\2024\JISBD2024-JAParejo\llms-design-patterns-evaluation\oodp-scenarios\behavioural\command\command-e2\target\classes\run2\RemoteControlTest.class", "Java", 0, 0, 0, 18, 0, 0, 0, 18
"c:\workspace\research\papers\2024\JISBD2024-JAParejo\llms-design-patterns-evaluation\oodp-scenarios\behavioural\command\command-e2\target\classes\run2\TurnOffCommand.class", "Java", 0, 0, 0, 12, 0, 0, 0, 12
"c:\workspace\research\papers\2024\JISBD2024-JAParejo\llms-design-patterns-evaluation\oodp-scenarios\behavioural\command\command-e2\target\classes\run2\TurnOnCommand.class", "Java", 0, 0, 0, 12, 0, 0, 0, 12
"c:\workspace\research\papers\2024\JISBD2024-JAParejo\llms-design-patterns-evaluation\oodp-scenarios\behavioural\command\command-e2\target\maven-archiver\pom.properties", "Java Properties", 0, 0, 0, 0, 3, 2, 1, 6
"c:\workspace\research\papers\2024\JISBD2024-JAParejo\llms-design-patterns-evaluation\oodp-scenarios\behavioural\strategy\strategy-e1\.mvn\wrapper\MavenWrapperDownloader.java", "Java", 0, 0, 0, 76, 0, 31, 11, 118
"c:\workspace\research\papers\2024\JISBD2024-JAParejo\llms-design-patterns-evaluation\oodp-scenarios\behavioural\strategy\strategy-e1\.mvn\wrapper\maven-wrapper.properties", "Java Properties", 0, 0, 0, 0, 2, 0, 1, 3
"c:\workspace\research\papers\2024\JISBD2024-JAParejo\llms-design-patterns-evaluation\oodp-scenarios\behavioural\strategy\strategy-e1\mvnw.cmd", "Batch", 0, 68, 0, 0, 0, 45, 32, 145
"c:\workspace\research\papers\2024\JISBD2024-JAParejo\llms-design-patterns-evaluation\oodp-scenarios\behavioural\strategy\strategy-e1\pom.xml", "XML", 13, 0, 0, 0, 0, 0, 4, 17
"c:\workspace\research\papers\2024\JISBD2024-JAParejo\llms-design-patterns-evaluation\oodp-scenarios\behavioural\strategy\strategy-e1\runs\run1.md", "Markdown", 0, 0, 525, 0, 0, 0, 156, 681
"c:\workspace\research\papers\2024\JISBD2024-JAParejo\llms-design-patterns-evaluation\oodp-scenarios\behavioural\strategy\strategy-e1\runs\run2.md", "Markdown", 0, 0, 402, 0, 0, 0, 113, 515
"c:\workspace\research\papers\2024\JISBD2024-JAParejo\llms-design-patterns-evaluation\oodp-scenarios\behavioural\strategy\strategy-e1\src\main\java\original\CreditCard.java", "Java", 0, 0, 0, 19, 0, 3, 6, 28
"c:\workspace\research\papers\2024\JISBD2024-JAParejo\llms-design-patterns-evaluation\oodp-scenarios\behavioural\strategy\strategy-e1\src\main\java\original\CreditCardPayment.java", "Java", 0, 0, 0, 33, 0, 7, 9, 49
"c:\workspace\research\papers\2024\JISBD2024-JAParejo\llms-design-patterns-evaluation\oodp-scenarios\behavioural\strategy\strategy-e1\src\main\java\original\Order.java", "Java", 0, 0, 0, 26, 0, 0, 7, 33
"c:\workspace\research\papers\2024\JISBD2024-JAParejo\llms-design-patterns-evaluation\oodp-scenarios\behavioural\strategy\strategy-e1\src\main\java\original\PayPalPayment.java", "Java", 0, 0, 0, 49, 0, 6, 9, 64
"c:\workspace\research\papers\2024\JISBD2024-JAParejo\llms-design-patterns-evaluation\oodp-scenarios\behavioural\strategy\strategy-e1\src\main\java\run1\CashPayment.java", "Java", 0, 0, 0, 12, 0, 2, 3, 17
"c:\workspace\research\papers\2024\JISBD2024-JAParejo\llms-design-patterns-evaluation\oodp-scenarios\behavioural\strategy\strategy-e1\src\main\java\run1\CreditCardPayment.java", "Java", 0, 0, 0, 39, 0, 1, 7, 47
"c:\workspace\research\papers\2024\JISBD2024-JAParejo\llms-design-patterns-evaluation\oodp-scenarios\behavioural\strategy\strategy-e1\src\main\java\run1\Order.java", "Java", 0, 0, 0, 25, 0, 0, 6, 31
"c:\workspace\research\papers\2024\JISBD2024-JAParejo\llms-design-patterns-evaluation\oodp-scenarios\behavioural\strategy\strategy-e1\src\main\java\run1\PayPalPayment.java", "Java", 0, 0, 0, 50, 0, 0, 9, 59
"c:\workspace\research\papers\2024\JISBD2024-JAParejo\llms-design-patterns-evaluation\oodp-scenarios\behavioural\strategy\strategy-e1\src\main\java\run1\PaymentMethod.java", "Java", 0, 0, 0, 5, 0, 0, 1, 6
"c:\workspace\research\papers\2024\JISBD2024-JAParejo\llms-design-patterns-evaluation\oodp-scenarios\behavioural\strategy\strategy-e1\src\main\java\run1\PaymentProcessingApplication.java", "Java", 0, 0, 0, 39, 0, 2, 15, 56
"c:\workspace\research\papers\2024\JISBD2024-JAParejo\llms-design-patterns-evaluation\oodp-scenarios\behavioural\strategy\strategy-e1\src\main\java\run2\CashPayment.java", "Java", 0, 0, 0, 14, 0, 2, 4, 20
"c:\workspace\research\papers\2024\JISBD2024-JAParejo\llms-design-patterns-evaluation\oodp-scenarios\behavioural\strategy\strategy-e1\src\main\java\run2\CreditCardPayment.java", "Java", 0, 0, 0, 33, 0, 0, 7, 40
"c:\workspace\research\papers\2024\JISBD2024-JAParejo\llms-design-patterns-evaluation\oodp-scenarios\behavioural\strategy\strategy-e1\src\main\java\run2\Order.java", "Java", 0, 0, 0, 28, 0, 0, 6, 34
"c:\workspace\research\papers\2024\JISBD2024-JAParejo\llms-design-patterns-evaluation\oodp-scenarios\behavioural\strategy\strategy-e1\src\main\java\run2\PayPalPayment.java", "Java", 0, 0, 0, 52, 0, 0, 8, 60
"c:\workspace\research\papers\2024\JISBD2024-JAParejo\llms-design-patterns-evaluation\oodp-scenarios\behavioural\strategy\strategy-e1\src\main\java\run2\Payment.java", "Java", 0, 0, 0, 5, 0, 0, 2, 7
"c:\workspace\research\papers\2024\JISBD2024-JAParejo\llms-design-patterns-evaluation\oodp-scenarios\behavioural\strategy\strategy-e1\src\main\java\run2\PaymentSystemDemo.java", "Java", 0, 0, 0, 33, 0, 6, 11, 50
"c:\workspace\research\papers\2024\JISBD2024-JAParejo\llms-design-patterns-evaluation\oodp-scenarios\behavioural\strategy\strategy-e1\target\classes\original\CreditCard.class", "Java", 0, 0, 0, 10, 0, 0, 0, 10
"c:\workspace\research\papers\2024\JISBD2024-JAParejo\llms-design-patterns-evaluation\oodp-scenarios\behavioural\strategy\strategy-e1\target\classes\original\CreditCardPayment.class", "Java", 0, 0, 0, 23, 0, 0, 0, 23
"c:\workspace\research\papers\2024\JISBD2024-JAParejo\llms-design-patterns-evaluation\oodp-scenarios\behavioural\strategy\strategy-e1\target\classes\original\Order.class", "Java", 0, 0, 0, 19, 0, 0, 0, 19
"c:\workspace\research\papers\2024\JISBD2024-JAParejo\llms-design-patterns-evaluation\oodp-scenarios\behavioural\strategy\strategy-e1\target\classes\original\PayPalPayment.class", "Java", 0, 0, 0, 29, 0, 0, 0, 29
"c:\workspace\research\papers\2024\JISBD2024-JAParejo\llms-design-patterns-evaluation\oodp-scenarios\behavioural\strategy\strategy-e1\target\classes\run1\CashPayment.class", "Java", 0, 0, 0, 11, 0, 0, 0, 11
"c:\workspace\research\papers\2024\JISBD2024-JAParejo\llms-design-patterns-evaluation\oodp-scenarios\behavioural\strategy\strategy-e1\target\classes\run1\CreditCardPayment.class", "Java", 0, 0, 0, 21, 0, 0, 0, 21
"c:\workspace\research\papers\2024\JISBD2024-JAParejo\llms-design-patterns-evaluation\oodp-scenarios\behavioural\strategy\strategy-e1\target\classes\run1\Order.class", "Java", 0, 0, 0, 17, 0, 0, 0, 17
"c:\workspace\research\papers\2024\JISBD2024-JAParejo\llms-design-patterns-evaluation\oodp-scenarios\behavioural\strategy\strategy-e1\target\classes\run1\PayPalPayment.class", "Java", 0, 0, 0, 27, 0, 0, 0, 27
"c:\workspace\research\papers\2024\JISBD2024-JAParejo\llms-design-patterns-evaluation\oodp-scenarios\behavioural\strategy\strategy-e1\target\classes\run1\PaymentMethod.class", "Java", 0, 0, 0, 2, 0, 0, 1, 3
"c:\workspace\research\papers\2024\JISBD2024-JAParejo\llms-design-patterns-evaluation\oodp-scenarios\behavioural\strategy\strategy-e1\target\classes\run1\PaymentProcessingApplication.class", "Java", 0, 0, 0, 26, 0, 0, 0, 26
"c:\workspace\research\papers\2024\JISBD2024-JAParejo\llms-design-patterns-evaluation\oodp-scenarios\behavioural\strategy\strategy-e1\target\classes\run2\CashPayment.class", "Java", 0, 0, 0, 10, 0, 0, 0, 10
"c:\workspace\research\papers\2024\JISBD2024-JAParejo\llms-design-patterns-evaluation\oodp-scenarios\behavioural\strategy\strategy-e1\target\classes\run2\CreditCardPayment.class", "Java", 0, 0, 0, 20, 0, 0, 0, 20
"c:\workspace\research\papers\2024\JISBD2024-JAParejo\llms-design-patterns-evaluation\oodp-scenarios\behavioural\strategy\strategy-e1\target\classes\run2\Order.class", "Java", 0, 0, 0, 18, 0, 0, 0, 18
"c:\workspace\research\papers\2024\JISBD2024-JAParejo\llms-design-patterns-evaluation\oodp-scenarios\behavioural\strategy\strategy-e1\target\classes\run2\PayPalPayment.class", "Java", 0, 0, 0, 30, 0, 0, 0, 30
"c:\workspace\research\papers\2024\JISBD2024-JAParejo\llms-design-patterns-evaluation\oodp-scenarios\behavioural\strategy\strategy-e1\target\classes\run2\Payment.class", "Java", 0, 0, 0, 2, 0, 0, 1, 3
"c:\workspace\research\papers\2024\JISBD2024-JAParejo\llms-design-patterns-evaluation\oodp-scenarios\behavioural\strategy\strategy-e1\target\classes\run2\PaymentSystemDemo.class", "Java", 0, 0, 0, 22, 0, 0, 0, 22
"c:\workspace\research\papers\2024\JISBD2024-JAParejo\llms-design-patterns-evaluation\oodp-scenarios\behavioural\strategy\strategy-e1\target\maven-archiver\pom.properties", "Java Properties", 0, 0, 0, 0, 3, 2, 1, 6
"c:\workspace\research\papers\2024\JISBD2024-JAParejo\llms-design-patterns-evaluation\oodp-scenarios\behavioural\strategy\strategy-e2\.mvn\wrapper\MavenWrapperDownloader.java", "Java", 0, 0, 0, 76, 0, 31, 11, 118
"c:\workspace\research\papers\2024\JISBD2024-JAParejo\llms-design-patterns-evaluation\oodp-scenarios\behavioural\strategy\strategy-e2\.mvn\wrapper\maven-wrapper.properties", "Java Properties", 0, 0, 0, 0, 2, 0, 1, 3
"c:\workspace\research\papers\2024\JISBD2024-JAParejo\llms-design-patterns-evaluation\oodp-scenarios\behavioural\strategy\strategy-e2\mvnw.cmd", "Batch", 0, 68, 0, 0, 0, 45, 32, 145
"c:\workspace\research\papers\2024\JISBD2024-JAParejo\llms-design-patterns-evaluation\oodp-scenarios\behavioural\strategy\strategy-e2\pom.xml", "XML", 19, 0, 0, 0, 0, 0, 5, 24
"c:\workspace\research\papers\2024\JISBD2024-JAParejo\llms-design-patterns-evaluation\oodp-scenarios\behavioural\strategy\strategy-e2\runs\run1.md", "Markdown", 0, 0, 152, 0, 0, 0, 55, 207
"c:\workspace\research\papers\2024\JISBD2024-JAParejo\llms-design-patterns-evaluation\oodp-scenarios\behavioural\strategy\strategy-e2\runs\run2.md", "Markdown", 0, 0, 156, 0, 0, 0, 58, 214
"c:\workspace\research\papers\2024\JISBD2024-JAParejo\llms-design-patterns-evaluation\oodp-scenarios\behavioural\strategy\strategy-e2\src\main\java\original\ChristmasDiscounter.java", "Java", 0, 0, 0, 7, 0, 0, 3, 10
"c:\workspace\research\papers\2024\JISBD2024-JAParejo\llms-design-patterns-evaluation\oodp-scenarios\behavioural\strategy\strategy-e2\src\main\java\original\EasterDiscounter.java", "Java", 0, 0, 0, 7, 0, 0, 4, 11
"c:\workspace\research\papers\2024\JISBD2024-JAParejo\llms-design-patterns-evaluation\oodp-scenarios\behavioural\strategy\strategy-e2\src\main\java\original\Order.java", "Java", 0, 0, 0, 24, 0, 0, 5, 29
"c:\workspace\research\papers\2024\JISBD2024-JAParejo\llms-design-patterns-evaluation\oodp-scenarios\behavioural\strategy\strategy-e2\src\main\java\original\SpecialOffer.java", "Java", 0, 0, 0, 8, 0, 0, 3, 11
"c:\workspace\research\papers\2024\JISBD2024-JAParejo\llms-design-patterns-evaluation\oodp-scenarios\behavioural\strategy\strategy-e2\src\main\java\run1\ChristmasDiscounter.java", "Java", 0, 0, 0, 8, 0, 0, 2, 10
"c:\workspace\research\papers\2024\JISBD2024-JAParejo\llms-design-patterns-evaluation\oodp-scenarios\behavioural\strategy\strategy-e2\src\main\java\run1\DiscountApplicationExample.java", "Java", 0, 0, 0, 21, 0, 4, 8, 33
"c:\workspace\research\papers\2024\JISBD2024-JAParejo\llms-design-patterns-evaluation\oodp-scenarios\behavioural\strategy\strategy-e2\src\main\java\run1\DiscountStrategy.java", "Java", 0, 0, 0, 5, 0, 0, 3, 8
"c:\workspace\research\papers\2024\JISBD2024-JAParejo\llms-design-patterns-evaluation\oodp-scenarios\behavioural\strategy\strategy-e2\src\main\java\run1\EasterDiscounter.java", "Java", 0, 0, 0, 8, 0, 0, 3, 11
"c:\workspace\research\papers\2024\JISBD2024-JAParejo\llms-design-patterns-evaluation\oodp-scenarios\behavioural\strategy\strategy-e2\src\main\java\run1\Order.java", "Java", 0, 0, 0, 21, 0, 0, 5, 26
"c:\workspace\research\papers\2024\JISBD2024-JAParejo\llms-design-patterns-evaluation\oodp-scenarios\behavioural\strategy\strategy-e2\src\main\java\run1\SpecialOffer.java", "Java", 0, 0, 0, 12, 0, 0, 5, 17
"c:\workspace\research\papers\2024\JISBD2024-JAParejo\llms-design-patterns-evaluation\oodp-scenarios\behavioural\strategy\strategy-e2\src\main\java\run2\ChristmasDiscounter.java", "Java", 0, 0, 0, 8, 0, 0, 4, 12
"c:\workspace\research\papers\2024\JISBD2024-JAParejo\llms-design-patterns-evaluation\oodp-scenarios\behavioural\strategy\strategy-e2\src\main\java\run2\DiscountApplicationExample.java", "Java", 0, 0, 0, 20, 0, 4, 8, 32
"c:\workspace\research\papers\2024\JISBD2024-JAParejo\llms-design-patterns-evaluation\oodp-scenarios\behavioural\strategy\strategy-e2\src\main\java\run2\DiscountStrategy.java", "Java", 0, 0, 0, 5, 0, 0, 2, 7
"c:\workspace\research\papers\2024\JISBD2024-JAParejo\llms-design-patterns-evaluation\oodp-scenarios\behavioural\strategy\strategy-e2\src\main\java\run2\EasterDiscounter.java", "Java", 0, 0, 0, 8, 0, 0, 4, 12
"c:\workspace\research\papers\2024\JISBD2024-JAParejo\llms-design-patterns-evaluation\oodp-scenarios\behavioural\strategy\strategy-e2\src\main\java\run2\Order.java", "Java", 0, 0, 0, 26, 0, 0, 6, 32
"c:\workspace\research\papers\2024\JISBD2024-JAParejo\llms-design-patterns-evaluation\oodp-scenarios\behavioural\strategy\strategy-e2\src\main\java\run2\SpecialOffer.java", "Java", 0, 0, 0, 12, 0, 0, 5, 17
"c:\workspace\research\papers\2024\JISBD2024-JAParejo\llms-design-patterns-evaluation\oodp-scenarios\behavioural\strategy\strategy-e2\target\classes\original\ChristmasDiscounter.class", "Java", 0, 0, 0, 8, 0, 0, 0, 8
"c:\workspace\research\papers\2024\JISBD2024-JAParejo\llms-design-patterns-evaluation\oodp-scenarios\behavioural\strategy\strategy-e2\target\classes\original\EasterDiscounter.class", "Java", 0, 0, 0, 9, 0, 0, 0, 9
"c:\workspace\research\papers\2024\JISBD2024-JAParejo\llms-design-patterns-evaluation\oodp-scenarios\behavioural\strategy\strategy-e2\target\classes\original\Order.class", "Java", 0, 0, 0, 19, 0, 0, 0, 19
"c:\workspace\research\papers\2024\JISBD2024-JAParejo\llms-design-patterns-evaluation\oodp-scenarios\behavioural\strategy\strategy-e2\target\classes\original\SpecialOffer.class", "Java", 0, 0, 0, 7, 0, 0, 0, 7
"c:\workspace\research\papers\2024\JISBD2024-JAParejo\llms-design-patterns-evaluation\oodp-scenarios\behavioural\strategy\strategy-e2\target\classes\run1\ChristmasDiscounter.class", "Java", 0, 0, 0, 9, 0, 0, 0, 9
"c:\workspace\research\papers\2024\JISBD2024-JAParejo\llms-design-patterns-evaluation\oodp-scenarios\behavioural\strategy\strategy-e2\target\classes\run1\DiscountApplicationExample.class", "Java", 0, 0, 0, 21, 0, 0, 0, 21
"c:\workspace\research\papers\2024\JISBD2024-JAParejo\llms-design-patterns-evaluation\oodp-scenarios\behavioural\strategy\strategy-e2\target\classes\run1\DiscountStrategy.class", "Java", 0, 0, 0, 3, 0, 0, 0, 3
"c:\workspace\research\papers\2024\JISBD2024-JAParejo\llms-design-patterns-evaluation\oodp-scenarios\behavioural\strategy\strategy-e2\target\classes\run1\EasterDiscounter.class", "Java", 0, 0, 0, 9, 0, 0, 0, 9
"c:\workspace\research\papers\2024\JISBD2024-JAParejo\llms-design-patterns-evaluation\oodp-scenarios\behavioural\strategy\strategy-e2\target\classes\run1\Order.class", "Java", 0, 0, 0, 19, 0, 0, 0, 19
"c:\workspace\research\papers\2024\JISBD2024-JAParejo\llms-design-patterns-evaluation\oodp-scenarios\behavioural\strategy\strategy-e2\target\classes\run1\SpecialOffer.class", "Java", 0, 0, 0, 11, 0, 0, 0, 11
"c:\workspace\research\papers\2024\JISBD2024-JAParejo\llms-design-patterns-evaluation\oodp-scenarios\behavioural\strategy\strategy-e2\target\classes\run2\ChristmasDiscounter.class", "Java", 0, 0, 0, 9, 0, 0, 0, 9
"c:\workspace\research\papers\2024\JISBD2024-JAParejo\llms-design-patterns-evaluation\oodp-scenarios\behavioural\strategy\strategy-e2\target\classes\run2\DiscountApplicationExample.class", "Java", 0, 0, 0, 26, 0, 0, 0, 26
"c:\workspace\research\papers\2024\JISBD2024-JAParejo\llms-design-patterns-evaluation\oodp-scenarios\behavioural\strategy\strategy-e2\target\classes\run2\DiscountStrategy.class", "Java", 0, 0, 0, 3, 0, 0, 0, 3
"c:\workspace\research\papers\2024\JISBD2024-JAParejo\llms-design-patterns-evaluation\oodp-scenarios\behavioural\strategy\strategy-e2\target\classes\run2\EasterDiscounter.class", "Java", 0, 0, 0, 9, 0, 0, 0, 9
"c:\workspace\research\papers\2024\JISBD2024-JAParejo\llms-design-patterns-evaluation\oodp-scenarios\behavioural\strategy\strategy-e2\target\classes\run2\Order.class", "Java", 0, 0, 0, 18, 0, 1, 0, 19
"c:\workspace\research\papers\2024\JISBD2024-JAParejo\llms-design-patterns-evaluation\oodp-scenarios\behavioural\strategy\strategy-e2\target\classes\run2\SpecialOffer.class", "Java", 0, 0, 0, 11, 0, 0, 0, 11
"c:\workspace\research\papers\2024\JISBD2024-JAParejo\llms-design-patterns-evaluation\oodp-scenarios\behavioural\strategy\strategy-e2\target\maven-archiver\pom.properties", "Java Properties", 0, 0, 0, 0, 3, 2, 1, 6
"c:\workspace\research\papers\2024\JISBD2024-JAParejo\llms-design-patterns-evaluation\oodp-scenarios\creational\builder\builder-e1\.mvn\wrapper\MavenWrapperDownloader.java", "Java", 0, 0, 0, 76, 0, 31, 11, 118
"c:\workspace\research\papers\2024\JISBD2024-JAParejo\llms-design-patterns-evaluation\oodp-scenarios\creational\builder\builder-e1\.mvn\wrapper\maven-wrapper.properties", "Java Properties", 0, 0, 0, 0, 2, 0, 1, 3
"c:\workspace\research\papers\2024\JISBD2024-JAParejo\llms-design-patterns-evaluation\oodp-scenarios\creational\builder\builder-e1\mvnw.cmd", "Batch", 0, 68, 0, 0, 0, 45, 32, 145
"c:\workspace\research\papers\2024\JISBD2024-JAParejo\llms-design-patterns-evaluation\oodp-scenarios\creational\builder\builder-e1\pom.xml", "XML", 19, 0, 0, 0, 0, 0, 5, 24
"c:\workspace\research\papers\2024\JISBD2024-JAParejo\llms-design-patterns-evaluation\oodp-scenarios\creational\builder\builder-e1\runs\run1.md", "Markdown", 0, 0, 231, 0, 0, 0, 69, 300
"c:\workspace\research\papers\2024\JISBD2024-JAParejo\llms-design-patterns-evaluation\oodp-scenarios\creational\builder\builder-e1\runs\run2.md", "Markdown", 0, 0, 284, 0, 0, 0, 88, 372
"c:\workspace\research\papers\2024\JISBD2024-JAParejo\llms-design-patterns-evaluation\oodp-scenarios\creational\builder\builder-e1\src\main\java\original\Car.java", "Java", 0, 0, 0, 46, 0, 0, 11, 57
"c:\workspace\research\papers\2024\JISBD2024-JAParejo\llms-design-patterns-evaluation\oodp-scenarios\creational\builder\builder-e1\src\main\java\original\CarType.java", "Java", 0, 0, 0, 4, 0, 0, 2, 6
"c:\workspace\research\papers\2024\JISBD2024-JAParejo\llms-design-patterns-evaluation\oodp-scenarios\creational\builder\builder-e1\src\main\java\original\Engine.java", "Java", 0, 0, 0, 32, 0, 0, 9, 41
"c:\workspace\research\papers\2024\JISBD2024-JAParejo\llms-design-patterns-evaluation\oodp-scenarios\creational\builder\builder-e1\src\main\java\original\GPSNavigator.java", "Java", 0, 0, 0, 13, 0, 0, 5, 18
"c:\workspace\research\papers\2024\JISBD2024-JAParejo\llms-design-patterns-evaluation\oodp-scenarios\creational\builder\builder-e1\src\main\java\original\Transmission.java", "Java", 0, 0, 0, 4, 0, 0, 2, 6
"c:\workspace\research\papers\2024\JISBD2024-JAParejo\llms-design-patterns-evaluation\oodp-scenarios\creational\builder\builder-e1\src\main\java\original\TripComputer.java", "Java", 0, 0, 0, 17, 0, 0, 6, 23
"c:\workspace\research\papers\2024\JISBD2024-JAParejo\llms-design-patterns-evaluation\oodp-scenarios\creational\builder\builder-e1\src\main\java\run1\CarApplication.java", "Java", 0, 0, 0, 47, 0, 3, 9, 59
"c:\workspace\research\papers\2024\JISBD2024-JAParejo\llms-design-patterns-evaluation\oodp-scenarios\creational\builder\builder-e1\src\main\java\run1\CarBuilder.java", "Java", 0, 0, 0, 42, 0, 0, 10, 52
"c:\workspace\research\papers\2024\JISBD2024-JAParejo\llms-design-patterns-evaluation\oodp-scenarios\creational\builder\builder-e1\src\main\java\run2\Car.java", "Java", 0, 0, 0, 48, 0, 1, 11, 60
"c:\workspace\research\papers\2024\JISBD2024-JAParejo\llms-design-patterns-evaluation\oodp-scenarios\creational\builder\builder-e1\src\main\java\run2\CarBuilder.java", "Java", 0, 0, 0, 46, 0, 1, 12, 59
"c:\workspace\research\papers\2024\JISBD2024-JAParejo\llms-design-patterns-evaluation\oodp-scenarios\creational\builder\builder-e1\src\main\java\run2\Main.java", "Java", 0, 0, 0, 36, 0, 0, 8, 44
"c:\workspace\research\papers\2024\JISBD2024-JAParejo\llms-design-patterns-evaluation\oodp-scenarios\creational\builder\builder-e1\src\main\java\run2\TripComputer.java", "Java", 0, 0, 0, 20, 0, 1, 8, 29
"c:\workspace\research\papers\2024\JISBD2024-JAParejo\llms-design-patterns-evaluation\oodp-scenarios\creational\builder\builder-e1\target\classes\original\Car.class", "Java", 0, 0, 0, 14, 0, 0, 0, 14
"c:\workspace\research\papers\2024\JISBD2024-JAParejo\llms-design-patterns-evaluation\oodp-scenarios\creational\builder\builder-e1\target\classes\original\CarType.class", "Java", 0, 0, 0, 15, 0, 0, 0, 15
"c:\workspace\research\papers\2024\JISBD2024-JAParejo\llms-design-patterns-evaluation\oodp-scenarios\creational\builder\builder-e1\target\classes\original\Engine.class", "Java", 0, 0, 0, 12, 0, 0, 0, 12
"c:\workspace\research\papers\2024\JISBD2024-JAParejo\llms-design-patterns-evaluation\oodp-scenarios\creational\builder\builder-e1\target\classes\original\GPSNavigator.class", "Java", 0, 0, 0, 11, 0, 0, 0, 11
"c:\workspace\research\papers\2024\JISBD2024-JAParejo\llms-design-patterns-evaluation\oodp-scenarios\creational\builder\builder-e1\target\classes\original\Transmission.class", "Java", 0, 0, 0, 11, 0, 0, 0, 11
"c:\workspace\research\papers\2024\JISBD2024-JAParejo\llms-design-patterns-evaluation\oodp-scenarios\creational\builder\builder-e1\target\classes\original\TripComputer.class", "Java", 0, 0, 0, 22, 0, 0, 0, 22
"c:\workspace\research\papers\2024\JISBD2024-JAParejo\llms-design-patterns-evaluation\oodp-scenarios\creational\builder\builder-e1\target\classes\run1\CarApplication.class", "Java", 0, 0, 0, 41, 0, 0, 0, 41
"c:\workspace\research\papers\2024\JISBD2024-JAParejo\llms-design-patterns-evaluation\oodp-scenarios\creational\builder\builder-e1\target\classes\run1\CarBuilder.class", "Java", 0, 0, 0, 18, 0, 0, 0, 18
"c:\workspace\research\papers\2024\JISBD2024-JAParejo\llms-design-patterns-evaluation\oodp-scenarios\creational\builder\builder-e1\target\classes\run2\Car.class", "Java", 0, 0, 0, 12, 0, 0, 0, 12
"c:\workspace\research\papers\2024\JISBD2024-JAParejo\llms-design-patterns-evaluation\oodp-scenarios\creational\builder\builder-e1\target\classes\run2\CarBuilder.class", "Java", 0, 0, 0, 19, 0, 0, 0, 19
"c:\workspace\research\papers\2024\JISBD2024-JAParejo\llms-design-patterns-evaluation\oodp-scenarios\creational\builder\builder-e1\target\classes\run2\Main.class", "Java", 0, 0, 0, 27, 0, 0, 1, 28
"c:\workspace\research\papers\2024\JISBD2024-JAParejo\llms-design-patterns-evaluation\oodp-scenarios\creational\builder\builder-e1\target\classes\run2\TripComputer.class", "Java", 0, 0, 0, 21, 0, 0, 0, 21
"c:\workspace\research\papers\2024\JISBD2024-JAParejo\llms-design-patterns-evaluation\oodp-scenarios\creational\builder\builder-e1\target\maven-archiver\pom.properties", "Java Properties", 0, 0, 0, 0, 3, 2, 1, 6
"c:\workspace\research\papers\2024\JISBD2024-JAParejo\llms-design-patterns-evaluation\oodp-scenarios\creational\builder\builder-e2\.mvn\wrapper\MavenWrapperDownloader.java", "Java", 0, 0, 0, 76, 0, 31, 11, 118
"c:\workspace\research\papers\2024\JISBD2024-JAParejo\llms-design-patterns-evaluation\oodp-scenarios\creational\builder\builder-e2\.mvn\wrapper\maven-wrapper.properties", "Java Properties", 0, 0, 0, 0, 2, 0, 1, 3
"c:\workspace\research\papers\2024\JISBD2024-JAParejo\llms-design-patterns-evaluation\oodp-scenarios\creational\builder\builder-e2\mvnw.cmd", "Batch", 0, 68, 0, 0, 0, 45, 32, 145
"c:\workspace\research\papers\2024\JISBD2024-JAParejo\llms-design-patterns-evaluation\oodp-scenarios\creational\builder\builder-e2\pom.xml", "XML", 19, 0, 0, 0, 0, 0, 5, 24
"c:\workspace\research\papers\2024\JISBD2024-JAParejo\llms-design-patterns-evaluation\oodp-scenarios\creational\builder\builder-e2\runs\run1.md", "Markdown", 0, 0, 584, 0, 0, 0, 156, 740
"c:\workspace\research\papers\2024\JISBD2024-JAParejo\llms-design-patterns-evaluation\oodp-scenarios\creational\builder\builder-e2\runs\run2.md", "Markdown", 0, 0, 549, 0, 0, 0, 153, 702
"c:\workspace\research\papers\2024\JISBD2024-JAParejo\llms-design-patterns-evaluation\oodp-scenarios\creational\builder\builder-e2\src\main\java\original\CPU.java", "Java", 0, 0, 0, 48, 0, 0, 15, 63
"c:\workspace\research\papers\2024\JISBD2024-JAParejo\llms-design-patterns-evaluation\oodp-scenarios\creational\builder\builder-e2\src\main\java\original\Computer.java", "Java", 0, 0, 0, 58, 0, 2, 7, 67
"c:\workspace\research\papers\2024\JISBD2024-JAParejo\llms-design-patterns-evaluation\oodp-scenarios\creational\builder\builder-e2\src\main\java\original\GraphicsCard.java", "Java", 0, 0, 0, 48, 0, 0, 14, 62
"c:\workspace\research\papers\2024\JISBD2024-JAParejo\llms-design-patterns-evaluation\oodp-scenarios\creational\builder\builder-e2\src\main\java\original\MemoryUnit.java", "Java", 0, 0, 0, 7, 0, 0, 1, 8
"c:\workspace\research\papers\2024\JISBD2024-JAParejo\llms-design-patterns-evaluation\oodp-scenarios\creational\builder\builder-e2\src\main\java\original\MotherBoard.java", "Java", 0, 0, 0, 208, 0, 0, 55, 263
"c:\workspace\research\papers\2024\JISBD2024-JAParejo\llms-design-patterns-evaluation\oodp-scenarios\creational\builder\builder-e2\src\main\java\original\RamMemoryCard.java", "Java", 0, 0, 0, 29, 0, 0, 11, 40
"c:\workspace\research\papers\2024\JISBD2024-JAParejo\llms-design-patterns-evaluation\oodp-scenarios\creational\builder\builder-e2\src\main\java\original\StorageSystem.java", "Java", 0, 0, 0, 56, 0, 0, 17, 73
"c:\workspace\research\papers\2024\JISBD2024-JAParejo\llms-design-patterns-evaluation\oodp-scenarios\creational\builder\builder-e2\src\main\java\original\StorageSystemType.java", "Java", 0, 0, 0, 4, 0, 0, 2, 6
"c:\workspace\research\papers\2024\JISBD2024-JAParejo\llms-design-patterns-evaluation\oodp-scenarios\creational\builder\builder-e2\src\main\java\run1\ComputerBuilder.java", "Java", 0, 0, 0, 55, 0, 2, 13, 70
"c:\workspace\research\papers\2024\JISBD2024-JAParejo\llms-design-patterns-evaluation\oodp-scenarios\creational\builder\builder-e2\src\main\java\run1\Main.java", "Java", 0, 0, 0, 36, 0, 2, 6, 44
"c:\workspace\research\papers\2024\JISBD2024-JAParejo\llms-design-patterns-evaluation\oodp-scenarios\creational\builder\builder-e2\src\main\java\run1\Main2.java", "Java", 0, 0, 0, 36, 0, 2, 5, 43
"c:\workspace\research\papers\2024\JISBD2024-JAParejo\llms-design-patterns-evaluation\oodp-scenarios\creational\builder\builder-e2\src\main\java\run2\ComputerBuilder.java", "Java", 0, 0, 0, 17, 0, 0, 3, 20
"c:\workspace\research\papers\2024\JISBD2024-JAParejo\llms-design-patterns-evaluation\oodp-scenarios\creational\builder\builder-e2\src\main\java\run2\ComputerBuilderImpl.java", "Java", 0, 0, 0, 46, 0, 0, 14, 60
"c:\workspace\research\papers\2024\JISBD2024-JAParejo\llms-design-patterns-evaluation\oodp-scenarios\creational\builder\builder-e2\src\main\java\run2\ComputerDirector.java", "Java", 0, 0, 0, 19, 0, 1, 3, 23
"c:\workspace\research\papers\2024\JISBD2024-JAParejo\llms-design-patterns-evaluation\oodp-scenarios\creational\builder\builder-e2\src\main\java\run2\ComputerShop.java", "Java", 0, 0, 0, 10, 0, 0, 3, 13
"c:\workspace\research\papers\2024\JISBD2024-JAParejo\llms-design-patterns-evaluation\oodp-scenarios\creational\builder\builder-e2\target\classes\original\CPU.class", "Java", 0, 0, 0, 19, 0, 0, 0, 19
"c:\workspace\research\papers\2024\JISBD2024-JAParejo\llms-design-patterns-evaluation\oodp-scenarios\creational\builder\builder-e2\target\classes\original\Computer.class", "Java", 0, 0, 0, 19, 0, 0, 0, 19
"c:\workspace\research\papers\2024\JISBD2024-JAParejo\llms-design-patterns-evaluation\oodp-scenarios\creational\builder\builder-e2\target\classes\original\GraphicsCard.class", "Java", 0, 0, 0, 14, 0, 0, 0, 14
"c:\workspace\research\papers\2024\JISBD2024-JAParejo\llms-design-patterns-evaluation\oodp-scenarios\creational\builder\builder-e2\target\classes\original\MemoryUnit.class", "Java", 0, 0, 0, 18, 0, 0, 0, 18
"c:\workspace\research\papers\2024\JISBD2024-JAParejo\llms-design-patterns-evaluation\oodp-scenarios\creational\builder\builder-e2\target\classes\original\MotherBoard.class", "Java", 0, 0, 0, 31, 0, 31, 0, 62
"c:\workspace\research\papers\2024\JISBD2024-JAParejo\llms-design-patterns-evaluation\oodp-scenarios\creational\builder\builder-e2\target\classes\original\RamMemoryCard.class", "Java", 0, 0, 0, 11, 0, 0, 0, 11
"c:\workspace\research\papers\2024\JISBD2024-JAParejo\llms-design-patterns-evaluation\oodp-scenarios\creational\builder\builder-e2\target\classes\original\StorageSystem.class", "Java", 0, 0, 0, 17, 0, 0, 0, 17
"c:\workspace\research\papers\2024\JISBD2024-JAParejo\llms-design-patterns-evaluation\oodp-scenarios\creational\builder\builder-e2\target\classes\original\StorageSystemType.class", "Java", 0, 0, 0, 17, 0, 0, 0, 17
"c:\workspace\research\papers\2024\JISBD2024-JAParejo\llms-design-patterns-evaluation\oodp-scenarios\creational\builder\builder-e2\target\classes\run1\ComputerBuilder.class", "Java", 0, 0, 0, 24, 0, 0, 0, 24
"c:\workspace\research\papers\2024\JISBD2024-JAParejo\llms-design-patterns-evaluation\oodp-scenarios\creational\builder\builder-e2\target\classes\run1\Main.class", "Java", 0, 0, 0, 27, 0, 0, 1, 28
"c:\workspace\research\papers\2024\JISBD2024-JAParejo\llms-design-patterns-evaluation\oodp-scenarios\creational\builder\builder-e2\target\classes\run1\Main2.class", "Java", 0, 0, 0, 43, 0, 0, 0, 43
"c:\workspace\research\papers\2024\JISBD2024-JAParejo\llms-design-patterns-evaluation\oodp-scenarios\creational\builder\builder-e2\target\classes\run2\ComputerBuilder.class", "Java", 0, 0, 0, 5, 0, 0, 0, 5
"c:\workspace\research\papers\2024\JISBD2024-JAParejo\llms-design-patterns-evaluation\oodp-scenarios\creational\builder\builder-e2\target\classes\run2\ComputerBuilderImpl.class", "Java", 0, 0, 0, 44, 0, 0, 0, 44
"c:\workspace\research\papers\2024\JISBD2024-JAParejo\llms-design-patterns-evaluation\oodp-scenarios\creational\builder\builder-e2\target\classes\run2\ComputerDirector.class", "Java", 0, 0, 0, 12, 0, 0, 0, 12
"c:\workspace\research\papers\2024\JISBD2024-JAParejo\llms-design-patterns-evaluation\oodp-scenarios\creational\builder\builder-e2\target\classes\run2\ComputerShop.class", "Java", 0, 0, 0, 12, 0, 0, 0, 12
"c:\workspace\research\papers\2024\JISBD2024-JAParejo\llms-design-patterns-evaluation\oodp-scenarios\creational\builder\builder-e2\target\maven-archiver\pom.properties", "Java Properties", 0, 0, 0, 0, 3, 2, 1, 6
"c:\workspace\research\papers\2024\JISBD2024-JAParejo\llms-design-patterns-evaluation\oodp-scenarios\creational\prototype\prototype-e1\.mvn\wrapper\MavenWrapperDownloader.java", "Java", 0, 0, 0, 76, 0, 31, 11, 118
"c:\workspace\research\papers\2024\JISBD2024-JAParejo\llms-design-patterns-evaluation\oodp-scenarios\creational\prototype\prototype-e1\.mvn\wrapper\maven-wrapper.properties", "Java Properties", 0, 0, 0, 0, 2, 0, 1, 3
"c:\workspace\research\papers\2024\JISBD2024-JAParejo\llms-design-patterns-evaluation\oodp-scenarios\creational\prototype\prototype-e1\mvnw.cmd", "Batch", 0, 68, 0, 0, 0, 45, 32, 145
"c:\workspace\research\papers\2024\JISBD2024-JAParejo\llms-design-patterns-evaluation\oodp-scenarios\creational\prototype\prototype-e1\pom.xml", "XML", 19, 0, 0, 0, 0, 0, 5, 24
"c:\workspace\research\papers\2024\JISBD2024-JAParejo\llms-design-patterns-evaluation\oodp-scenarios\creational\prototype\prototype-e1\runs\run1.md", "Markdown", 0, 0, 511, 0, 0, 0, 160, 671
"c:\workspace\research\papers\2024\JISBD2024-JAParejo\llms-design-patterns-evaluation\oodp-scenarios\creational\prototype\prototype-e1\runs\run2.md", "Markdown", 0, 0, 377, 0, 0, 0, 131, 508
"c:\workspace\research\papers\2024\JISBD2024-JAParejo\llms-design-patterns-evaluation\oodp-scenarios\creational\prototype\prototype-e1\src\main\java\original\Circle.java", "Java", 0, 0, 0, 22, 0, 1, 9, 32
"c:\workspace\research\papers\2024\JISBD2024-JAParejo\llms-design-patterns-evaluation\oodp-scenarios\creational\prototype\prototype-e1\src\main\java\original\ComplexShape.java", "Java", 0, 0, 0, 22, 0, 0, 8, 30
"c:\workspace\research\papers\2024\JISBD2024-JAParejo\llms-design-patterns-evaluation\oodp-scenarios\creational\prototype\prototype-e1\src\main\java\original\Line.java", "Java", 0, 0, 0, 32, 0, 1, 11, 44
"c:\workspace\research\papers\2024\JISBD2024-JAParejo\llms-design-patterns-evaluation\oodp-scenarios\creational\prototype\prototype-e1\src\main\java\original\Rectangle.java", "Java", 0, 0, 0, 30, 0, 1, 8, 39
"c:\workspace\research\papers\2024\JISBD2024-JAParejo\llms-design-patterns-evaluation\oodp-scenarios\creational\prototype\prototype-e1\src\main\java\original\Shape.java", "Java", 0, 0, 0, 31, 0, 0, 12, 43
"c:\workspace\research\papers\2024\JISBD2024-JAParejo\llms-design-patterns-evaluation\oodp-scenarios\creational\prototype\prototype-e1\src\main\java\run1\Circle.java", "Java", 0, 0, 0, 21, 0, 1, 7, 29
"c:\workspace\research\papers\2024\JISBD2024-JAParejo\llms-design-patterns-evaluation\oodp-scenarios\creational\prototype\prototype-e1\src\main\java\run1\ComplexShape.java", "Java", 0, 0, 0, 34, 0, 1, 8, 43
"c:\workspace\research\papers\2024\JISBD2024-JAParejo\llms-design-patterns-evaluation\oodp-scenarios\creational\prototype\prototype-e1\src\main\java\run1\Line.java", "Java", 0, 0, 0, 25, 0, 1, 7, 33
"c:\workspace\research\papers\2024\JISBD2024-JAParejo\llms-design-patterns-evaluation\oodp-scenarios\creational\prototype\prototype-e1\src\main\java\run1\Rectangle.java", "Java", 0, 0, 0, 23, 0, 1, 7, 31
"c:\workspace\research\papers\2024\JISBD2024-JAParejo\llms-design-patterns-evaluation\oodp-scenarios\creational\prototype\prototype-e1\src\main\java\run1\Shape.java", "Java", 0, 0, 0, 35, 0, 2, 11, 48
"c:\workspace\research\papers\2024\JISBD2024-JAParejo\llms-design-patterns-evaluation\oodp-scenarios\creational\prototype\prototype-e1\src\main\java\run1\ShapeExample.java", "Java", 0, 0, 0, 28, 0, 6, 10, 44
"c:\workspace\research\papers\2024\JISBD2024-JAParejo\llms-design-patterns-evaluation\oodp-scenarios\creational\prototype\prototype-e1\src\main\java\run2\Circle.java", "Java", 0, 0, 0, 20, 0, 2, 7, 29
"c:\workspace\research\papers\2024\JISBD2024-JAParejo\llms-design-patterns-evaluation\oodp-scenarios\creational\prototype\prototype-e1\src\main\java\run2\CloneableShape.java", "Java", 0, 0, 0, 4, 0, 0, 2, 6
"c:\workspace\research\papers\2024\JISBD2024-JAParejo\llms-design-patterns-evaluation\oodp-scenarios\creational\prototype\prototype-e1\src\main\java\run2\ComplexShape.java", "Java", 0, 0, 0, 30, 0, 0, 7, 37
"c:\workspace\research\papers\2024\JISBD2024-JAParejo\llms-design-patterns-evaluation\oodp-scenarios\creational\prototype\prototype-e1\src\main\java\run2\Line.java", "Java", 0, 0, 0, 24, 0, 2, 7, 33
"c:\workspace\research\papers\2024\JISBD2024-JAParejo\llms-design-patterns-evaluation\oodp-scenarios\creational\prototype\prototype-e1\src\main\java\run2\Rectangle.java", "Java", 0, 0, 0, 34, 0, 1, 10, 45
"c:\workspace\research\papers\2024\JISBD2024-JAParejo\llms-design-patterns-evaluation\oodp-scenarios\creational\prototype\prototype-e1\src\main\java\run2\Shape.java", "Java", 0, 0, 0, 32, 0, 3, 10, 45
"c:\workspace\research\papers\2024\JISBD2024-JAParejo\llms-design-patterns-evaluation\oodp-scenarios\creational\prototype\prototype-e1\src\main\java\run2\ShapeDemo.java", "Java", 0, 0, 0, 24, 0, 7, 10, 41
"c:\workspace\research\papers\2024\JISBD2024-JAParejo\llms-design-patterns-evaluation\oodp-scenarios\creational\prototype\prototype-e1\target\classes\original\Circle.class", "Java", 0, 0, 0, 12, 0, 0, 0, 12
"c:\workspace\research\papers\2024\JISBD2024-JAParejo\llms-design-patterns-evaluation\oodp-scenarios\creational\prototype\prototype-e1\target\classes\original\ComplexShape.class", "Java", 0, 0, 0, 14, 0, 0, 0, 14
"c:\workspace\research\papers\2024\JISBD2024-JAParejo\llms-design-patterns-evaluation\oodp-scenarios\creational\prototype\prototype-e1\target\classes\original\Line.class", "Java", 0, 0, 0, 19, 0, 0, 0, 19
"c:\workspace\research\papers\2024\JISBD2024-JAParejo\llms-design-patterns-evaluation\oodp-scenarios\creational\prototype\prototype-e1\target\classes\original\Rectangle.class", "Java", 0, 0, 0, 17, 0, 0, 0, 17
"c:\workspace\research\papers\2024\JISBD2024-JAParejo\llms-design-patterns-evaluation\oodp-scenarios\creational\prototype\prototype-e1\target\classes\original\Shape.class", "Java", 0, 0, 0, 12, 0, 0, 0, 12
"c:\workspace\research\papers\2024\JISBD2024-JAParejo\llms-design-patterns-evaluation\oodp-scenarios\creational\prototype\prototype-e1\target\classes\run1\Circle.class", "Java", 0, 0, 0, 21, 0, 0, 0, 21
"c:\workspace\research\papers\2024\JISBD2024-JAParejo\llms-design-patterns-evaluation\oodp-scenarios\creational\prototype\prototype-e1\target\classes\run1\ComplexShape.class", "Java", 0, 0, 0, 20, 0, 0, 0, 20
"c:\workspace\research\papers\2024\JISBD2024-JAParejo\llms-design-patterns-evaluation\oodp-scenarios\creational\prototype\prototype-e1\target\classes\run1\Line.class", "Java", 0, 0, 0, 21, 0, 4, 0, 25
"c:\workspace\research\papers\2024\JISBD2024-JAParejo\llms-design-patterns-evaluation\oodp-scenarios\creational\prototype\prototype-e1\target\classes\run1\Rectangle.class", "Java", 0, 0, 0, 22, 0, 0, 0, 22
"c:\workspace\research\papers\2024\JISBD2024-JAParejo\llms-design-patterns-evaluation\oodp-scenarios\creational\prototype\prototype-e1\target\classes\run1\Shape.class", "Java", 0, 0, 0, 16, 0, 0, 0, 16
"c:\workspace\research\papers\2024\JISBD2024-JAParejo\llms-design-patterns-evaluation\oodp-scenarios\creational\prototype\prototype-e1\target\classes\run1\ShapeExample.class", "Java", 0, 0, 0, 24, 0, 0, 0, 24
"c:\workspace\research\papers\2024\JISBD2024-JAParejo\llms-design-patterns-evaluation\oodp-scenarios\creational\prototype\prototype-e1\target\classes\run2\Circle.class", "Java", 0, 0, 0, 15, 0, 0, 0, 15
"c:\workspace\research\papers\2024\JISBD2024-JAParejo\llms-design-patterns-evaluation\oodp-scenarios\creational\prototype\prototype-e1\target\classes\run2\CloneableShape.class", "Java", 0, 0, 0, 3, 0, 0, 0, 3
"c:\workspace\research\papers\2024\JISBD2024-JAParejo\llms-design-patterns-evaluation\oodp-scenarios\creational\prototype\prototype-e1\target\classes\run2\ComplexShape.class", "Java", 0, 0, 0, 24, 0, 0, 0, 24
"c:\workspace\research\papers\2024\JISBD2024-JAParejo\llms-design-patterns-evaluation\oodp-scenarios\creational\prototype\prototype-e1\target\classes\run2\Line.class", "Java", 0, 0, 0, 18, 0, 0, 0, 18
"c:\workspace\research\papers\2024\JISBD2024-JAParejo\llms-design-patterns-evaluation\oodp-scenarios\creational\prototype\prototype-e1\target\classes\run2\Rectangle.class", "Java", 0, 0, 0, 20, 0, 0, 0, 20
"c:\workspace\research\papers\2024\JISBD2024-JAParejo\llms-design-patterns-evaluation\oodp-scenarios\creational\prototype\prototype-e1\target\classes\run2\Shape.class", "Java", 0, 0, 0, 15, 0, 0, 0, 15
"c:\workspace\research\papers\2024\JISBD2024-JAParejo\llms-design-patterns-evaluation\oodp-scenarios\creational\prototype\prototype-e1\target\classes\run2\ShapeDemo.class", "Java", 0, 0, 0, 26, 0, 0, 0, 26
"c:\workspace\research\papers\2024\JISBD2024-JAParejo\llms-design-patterns-evaluation\oodp-scenarios\creational\prototype\prototype-e1\target\maven-archiver\pom.properties", "Java Properties", 0, 0, 0, 0, 3, 2, 1, 6
"c:\workspace\research\papers\2024\JISBD2024-JAParejo\llms-design-patterns-evaluation\oodp-scenarios\creational\prototype\prototype-e2\.mvn\wrapper\MavenWrapperDownloader.java", "Java", 0, 0, 0, 76, 0, 31, 11, 118
"c:\workspace\research\papers\2024\JISBD2024-JAParejo\llms-design-patterns-evaluation\oodp-scenarios\creational\prototype\prototype-e2\.mvn\wrapper\maven-wrapper.properties", "Java Properties", 0, 0, 0, 0, 2, 0, 1, 3
"c:\workspace\research\papers\2024\JISBD2024-JAParejo\llms-design-patterns-evaluation\oodp-scenarios\creational\prototype\prototype-e2\mvnw.cmd", "Batch", 0, 68, 0, 0, 0, 45, 32, 145
"c:\workspace\research\papers\2024\JISBD2024-JAParejo\llms-design-patterns-evaluation\oodp-scenarios\creational\prototype\prototype-e2\pom.xml", "XML", 19, 0, 0, 0, 0, 0, 5, 24
"c:\workspace\research\papers\2024\JISBD2024-JAParejo\llms-design-patterns-evaluation\oodp-scenarios\creational\prototype\prototype-e2\runs\run1.md", "Markdown", 0, 0, 226, 0, 0, 0, 83, 309
"c:\workspace\research\papers\2024\JISBD2024-JAParejo\llms-design-patterns-evaluation\oodp-scenarios\creational\prototype\prototype-e2\runs\run2.md", "Markdown", 0, 0, 230, 0, 0, 0, 76, 306
"c:\workspace\research\papers\2024\JISBD2024-JAParejo\llms-design-patterns-evaluation\oodp-scenarios\creational\prototype\prototype-e2\src\main\java\original\PineTree.java", "Java", 0, 0, 0, 9, 0, 0, 6, 15
"c:\workspace\research\papers\2024\JISBD2024-JAParejo\llms-design-patterns-evaluation\oodp-scenarios\creational\prototype\prototype-e2\src\main\java\original\PlasticTree.java", "Java", 0, 0, 0, 9, 0, 0, 5, 14
"c:\workspace\research\papers\2024\JISBD2024-JAParejo\llms-design-patterns-evaluation\oodp-scenarios\creational\prototype\prototype-e2\src\main\java\original\Tree.java", "Java", 0, 0, 0, 42, 0, 0, 9, 51
"c:\workspace\research\papers\2024\JISBD2024-JAParejo\llms-design-patterns-evaluation\oodp-scenarios\creational\prototype\prototype-e2\src\main\java\run1\PineTree.java", "Java", 0, 0, 0, 14, 0, 0, 4, 18
"c:\workspace\research\papers\2024\JISBD2024-JAParejo\llms-design-patterns-evaluation\oodp-scenarios\creational\prototype\prototype-e2\src\main\java\run1\PlasticTree.java", "Java", 0, 0, 0, 14, 0, 0, 5, 19
"c:\workspace\research\papers\2024\JISBD2024-JAParejo\llms-design-patterns-evaluation\oodp-scenarios\creational\prototype\prototype-e2\src\main\java\run1\Tree.java", "Java", 0, 0, 0, 28, 0, 1, 7, 36
"c:\workspace\research\papers\2024\JISBD2024-JAParejo\llms-design-patterns-evaluation\oodp-scenarios\creational\prototype\prototype-e2\src\main\java\run1\TreeExample.java", "Java", 0, 0, 0, 15, 0, 6, 9, 30
"c:\workspace\research\papers\2024\JISBD2024-JAParejo\llms-design-patterns-evaluation\oodp-scenarios\creational\prototype\prototype-e2\src\main\java\run2\Main.java", "Java", 0, 0, 0, 12, 0, 4, 5, 21
"c:\workspace\research\papers\2024\JISBD2024-JAParejo\llms-design-patterns-evaluation\oodp-scenarios\creational\prototype\prototype-e2\src\main\java\run2\PineTree.java", "Java", 0, 0, 0, 14, 0, 0, 3, 17
"c:\workspace\research\papers\2024\JISBD2024-JAParejo\llms-design-patterns-evaluation\oodp-scenarios\creational\prototype\prototype-e2\src\main\java\run2\PlasticTree.java", "Java", 0, 0, 0, 14, 0, 0, 4, 18
"c:\workspace\research\papers\2024\JISBD2024-JAParejo\llms-design-patterns-evaluation\oodp-scenarios\creational\prototype\prototype-e2\src\main\java\run2\Tree.java", "Java", 0, 0, 0, 28, 0, 1, 6, 35
"c:\workspace\research\papers\2024\JISBD2024-JAParejo\llms-design-patterns-evaluation\oodp-scenarios\creational\prototype\prototype-e2\target\classes\original\PineTree.class", "Java", 0, 0, 0, 15, 0, 0, 0, 15
"c:\workspace\research\papers\2024\JISBD2024-JAParejo\llms-design-patterns-evaluation\oodp-scenarios\creational\prototype\prototype-e2\target\classes\original\PlasticTree.class", "Java", 0, 0, 0, 15, 0, 0, 0, 15
"c:\workspace\research\papers\2024\JISBD2024-JAParejo\llms-design-patterns-evaluation\oodp-scenarios\creational\prototype\prototype-e2\target\classes\original\Tree.class", "Java", 0, 0, 0, 15, 0, 0, 0, 15
"c:\workspace\research\papers\2024\JISBD2024-JAParejo\llms-design-patterns-evaluation\oodp-scenarios\creational\prototype\prototype-e2\target\classes\run1\PineTree.class", "Java", 0, 0, 0, 20, 0, 0, 0, 20
"c:\workspace\research\papers\2024\JISBD2024-JAParejo\llms-design-patterns-evaluation\oodp-scenarios\creational\prototype\prototype-e2\target\classes\run1\PlasticTree.class", "Java", 0, 0, 0, 18, 0, 0, 0, 18
"c:\workspace\research\papers\2024\JISBD2024-JAParejo\llms-design-patterns-evaluation\oodp-scenarios\creational\prototype\prototype-e2\target\classes\run1\Tree.class", "Java", 0, 0, 0, 16, 0, 0, 0, 16
"c:\workspace\research\papers\2024\JISBD2024-JAParejo\llms-design-patterns-evaluation\oodp-scenarios\creational\prototype\prototype-e2\target\classes\run1\TreeExample.class", "Java", 0, 0, 0, 15, 0, 0, 0, 15
"c:\workspace\research\papers\2024\JISBD2024-JAParejo\llms-design-patterns-evaluation\oodp-scenarios\creational\prototype\prototype-e2\target\classes\run2\Main.class", "Java", 0, 0, 0, 15, 0, 0, 0, 15
"c:\workspace\research\papers\2024\JISBD2024-JAParejo\llms-design-patterns-evaluation\oodp-scenarios\creational\prototype\prototype-e2\target\classes\run2\PineTree.class", "Java", 0, 0, 0, 20, 0, 0, 0, 20
"c:\workspace\research\papers\2024\JISBD2024-JAParejo\llms-design-patterns-evaluation\oodp-scenarios\creational\prototype\prototype-e2\target\classes\run2\PlasticTree.class", "Java", 0, 0, 0, 18, 0, 0, 0, 18
"c:\workspace\research\papers\2024\JISBD2024-JAParejo\llms-design-patterns-evaluation\oodp-scenarios\creational\prototype\prototype-e2\target\classes\run2\Tree.class", "Java", 0, 0, 0, 15, 0, 0, 0, 15
"c:\workspace\research\papers\2024\JISBD2024-JAParejo\llms-design-patterns-evaluation\oodp-scenarios\creational\prototype\prototype-e2\target\maven-archiver\pom.properties", "Java Properties", 0, 0, 0, 0, 3, 2, 1, 6
"c:\workspace\research\papers\2024\JISBD2024-JAParejo\llms-design-patterns-evaluation\oodp-scenarios\mvnw.cmd", "Batch", 0, 68, 0, 0, 0, 45, 32, 145
"c:\workspace\research\papers\2024\JISBD2024-JAParejo\llms-design-patterns-evaluation\oodp-scenarios\pom.xml", "XML", 38, 0, 0, 0, 0, 0, 5, 43
"c:\workspace\research\papers\2024\JISBD2024-JAParejo\llms-design-patterns-evaluation\oodp-scenarios\structural\adapter\adapter-e1\.mvn\wrapper\MavenWrapperDownloader.java", "Java", 0, 0, 0, 76, 0, 31, 11, 118
"c:\workspace\research\papers\2024\JISBD2024-JAParejo\llms-design-patterns-evaluation\oodp-scenarios\structural\adapter\adapter-e1\.mvn\wrapper\maven-wrapper.properties", "Java Properties", 0, 0, 0, 0, 1, 0, 1, 2
"c:\workspace\research\papers\2024\JISBD2024-JAParejo\llms-design-patterns-evaluation\oodp-scenarios\structural\adapter\adapter-e1\mvnw.cmd", "Batch", 0, 68, 0, 0, 0, 45, 32, 145
"c:\workspace\research\papers\2024\JISBD2024-JAParejo\llms-design-patterns-evaluation\oodp-scenarios\structural\adapter\adapter-e1\pom.xml", "XML", 19, 0, 0, 0, 0, 0, 5, 24
"c:\workspace\research\papers\2024\JISBD2024-JAParejo\llms-design-patterns-evaluation\oodp-scenarios\structural\adapter\adapter-e1\runs\run1.md", "Markdown", 0, 0, 284, 0, 0, 0, 101, 385
"c:\workspace\research\papers\2024\JISBD2024-JAParejo\llms-design-patterns-evaluation\oodp-scenarios\structural\adapter\adapter-e1\runs\run2.md", "Markdown", 0, 0, 274, 0, 0, 0, 93, 367
"c:\workspace\research\papers\2024\JISBD2024-JAParejo\llms-design-patterns-evaluation\oodp-scenarios\structural\adapter\adapter-e1\src\main\java\original\Circle.java", "Java", 0, 0, 0, 19, 0, 0, 6, 25
"c:\workspace\research\papers\2024\JISBD2024-JAParejo\llms-design-patterns-evaluation\oodp-scenarios\structural\adapter\adapter-e1\src\main\java\original\Drawing.java", "Java", 0, 0, 0, 29, 0, 0, 8, 37
"c:\workspace\research\papers\2024\JISBD2024-JAParejo\llms-design-patterns-evaluation\oodp-scenarios\structural\adapter\adapter-e1\src\main\java\original\GeometricShape.java", "Java", 0, 0, 0, 6, 0, 0, 1, 7
"c:\workspace\research\papers\2024\JISBD2024-JAParejo\llms-design-patterns-evaluation\oodp-scenarios\structural\adapter\adapter-e1\src\main\java\original\Main.java", "Java", 0, 0, 0, 15, 0, 0, 6, 21
"c:\workspace\research\papers\2024\JISBD2024-JAParejo\llms-design-patterns-evaluation\oodp-scenarios\structural\adapter\adapter-e1\src\main\java\original\Rectangle.java", "Java", 0, 0, 0, 19, 0, 0, 5, 24
"c:\workspace\research\papers\2024\JISBD2024-JAParejo\llms-design-patterns-evaluation\oodp-scenarios\structural\adapter\adapter-e1\src\main\java\original\Rhombus.java", "Java", 0, 0, 0, 25, 0, 1, 7, 33
"c:\workspace\research\papers\2024\JISBD2024-JAParejo\llms-design-patterns-evaluation\oodp-scenarios\structural\adapter\adapter-e1\src\main\java\original\Shape.java", "Java", 0, 0, 0, 7, 0, 0, 1, 8
"c:\workspace\research\papers\2024\JISBD2024-JAParejo\llms-design-patterns-evaluation\oodp-scenarios\structural\adapter\adapter-e1\src\main\java\original\Triangle.java", "Java", 0, 0, 0, 27, 0, 5, 7, 39
"c:\workspace\research\papers\2024\JISBD2024-JAParejo\llms-design-patterns-evaluation\oodp-scenarios\structural\adapter\adapter-e1\src\main\java\run1\GeometricShapeAdapter.java", "Java", 0, 0, 0, 25, 0, 3, 7, 35
"c:\workspace\research\papers\2024\JISBD2024-JAParejo\llms-design-patterns-evaluation\oodp-scenarios\structural\adapter\adapter-e1\src\main\java\run1\Main.java", "Java", 0, 0, 0, 22, 0, 2, 6, 30
"c:\workspace\research\papers\2024\JISBD2024-JAParejo\llms-design-patterns-evaluation\oodp-scenarios\structural\adapter\adapter-e1\src\main\java\run2\GeometricShapeAdapter.java", "Java", 0, 0, 0, 25, 0, 3, 7, 35
"c:\workspace\research\papers\2024\JISBD2024-JAParejo\llms-design-patterns-evaluation\oodp-scenarios\structural\adapter\adapter-e1\src\main\java\run2\Main.java", "Java", 0, 0, 0, 22, 0, 2, 6, 30
"c:\workspace\research\papers\2024\JISBD2024-JAParejo\llms-design-patterns-evaluation\oodp-scenarios\structural\adapter\adapter-e1\target\classes\original\Circle.class", "Java", 0, 0, 0, 13, 0, 0, 0, 13
"c:\workspace\research\papers\2024\JISBD2024-JAParejo\llms-design-patterns-evaluation\oodp-scenarios\structural\adapter\adapter-e1\target\classes\original\Drawing.class", "Java", 0, 0, 0, 23, 0, 0, 0, 23
"c:\workspace\research\papers\2024\JISBD2024-JAParejo\llms-design-patterns-evaluation\oodp-scenarios\structural\adapter\adapter-e1\target\classes\original\GeometricShape.class", "Java", 0, 0, 0, 3, 0, 0, 0, 3
"c:\workspace\research\papers\2024\JISBD2024-JAParejo\llms-design-patterns-evaluation\oodp-scenarios\structural\adapter\adapter-e1\target\classes\original\Main.class", "Java", 0, 0, 0, 12, 0, 0, 1, 13
"c:\workspace\research\papers\2024\JISBD2024-JAParejo\llms-design-patterns-evaluation\oodp-scenarios\structural\adapter\adapter-e1\target\classes\original\Rectangle.class", "Java", 0, 0, 0, 12, 0, 0, 0, 12
"c:\workspace\research\papers\2024\JISBD2024-JAParejo\llms-design-patterns-evaluation\oodp-scenarios\structural\adapter\adapter-e1\target\classes\original\Rhombus.class", "Java", 0, 0, 0, 20, 0, 0, 0, 20
"c:\workspace\research\papers\2024\JISBD2024-JAParejo\llms-design-patterns-evaluation\oodp-scenarios\structural\adapter\adapter-e1\target\classes\original\Shape.class", "Java", 0, 0, 0, 4, 0, 0, 1, 5
"c:\workspace\research\papers\2024\JISBD2024-JAParejo\llms-design-patterns-evaluation\oodp-scenarios\structural\adapter\adapter-e1\target\classes\original\Triangle.class", "Java", 0, 0, 0, 24, 0, 0, 0, 24
"c:\workspace\research\papers\2024\JISBD2024-JAParejo\llms-design-patterns-evaluation\oodp-scenarios\structural\adapter\adapter-e1\target\classes\run1\GeometricShapeAdapter.class", "Java", 0, 0, 0, 14, 0, 0, 0, 14
"c:\workspace\research\papers\2024\JISBD2024-JAParejo\llms-design-patterns-evaluation\oodp-scenarios\structural\adapter\adapter-e1\target\classes\run1\Main.class", "Java", 0, 0, 0, 18, 0, 0, 0, 18
"c:\workspace\research\papers\2024\JISBD2024-JAParejo\llms-design-patterns-evaluation\oodp-scenarios\structural\adapter\adapter-e1\target\classes\run2\GeometricShapeAdapter.class", "Java", 0, 0, 0, 18, 0, 0, 1, 19
"c:\workspace\research\papers\2024\JISBD2024-JAParejo\llms-design-patterns-evaluation\oodp-scenarios\structural\adapter\adapter-e1\target\classes\run2\Main.class", "Java", 0, 0, 0, 11, 0, 0, 1, 12
"c:\workspace\research\papers\2024\JISBD2024-JAParejo\llms-design-patterns-evaluation\oodp-scenarios\structural\adapter\adapter-e1\target\maven-archiver\pom.properties", "Java Properties", 0, 0, 0, 0, 3, 2, 1, 6
"c:\workspace\research\papers\2024\JISBD2024-JAParejo\llms-design-patterns-evaluation\oodp-scenarios\structural\adapter\adapter-e2\.mvn\wrapper\MavenWrapperDownloader.java", "Java", 0, 0, 0, 76, 0, 31, 11, 118
"c:\workspace\research\papers\2024\JISBD2024-JAParejo\llms-design-patterns-evaluation\oodp-scenarios\structural\adapter\adapter-e2\.mvn\wrapper\maven-wrapper.properties", "Java Properties", 0, 0, 0, 0, 1, 0, 1, 2
"c:\workspace\research\papers\2024\JISBD2024-JAParejo\llms-design-patterns-evaluation\oodp-scenarios\structural\adapter\adapter-e2\mvnw.cmd", "Batch", 0, 68, 0, 0, 0, 45, 32, 145
"c:\workspace\research\papers\2024\JISBD2024-JAParejo\llms-design-patterns-evaluation\oodp-scenarios\structural\adapter\adapter-e2\pom.xml", "XML", 19, 0, 0, 0, 0, 0, 5, 24
"c:\workspace\research\papers\2024\JISBD2024-JAParejo\llms-design-patterns-evaluation\oodp-scenarios\structural\adapter\adapter-e2\runs\run1\run1.md", "Markdown", 0, 0, 235, 0, 0, 0, 71, 306
"c:\workspace\research\papers\2024\JISBD2024-JAParejo\llms-design-patterns-evaluation\oodp-scenarios\structural\adapter\adapter-e2\runs\run1\run2.md", "Markdown", 0, 0, 125, 0, 0, 0, 38, 163
"c:\workspace\research\papers\2024\JISBD2024-JAParejo\llms-design-patterns-evaluation\oodp-scenarios\structural\adapter\adapter-e2\src\main\java\original\Demo.java", "Java", 0, 0, 0, 18, 0, 1, 3, 22
"c:\workspace\research\papers\2024\JISBD2024-JAParejo\llms-design-patterns-evaluation\oodp-scenarios\structural\adapter\adapter-e2\src\main\java\original\RoundHole.java", "Java", 0, 0, 0, 15, 0, 0, 3, 18
"c:\workspace\research\papers\2024\JISBD2024-JAParejo\llms-design-patterns-evaluation\oodp-scenarios\structural\adapter\adapter-e2\src\main\java\original\RoundPeg.java", "Java", 0, 0, 0, 10, 0, 0, 4, 14
"c:\workspace\research\papers\2024\JISBD2024-JAParejo\llms-design-patterns-evaluation\oodp-scenarios\structural\adapter\adapter-e2\src\main\java\original\SquarePeg.java", "Java", 0, 0, 0, 14, 0, 0, 4, 18
"c:\workspace\research\papers\2024\JISBD2024-JAParejo\llms-design-patterns-evaluation\oodp-scenarios\structural\adapter\adapter-e2\src\main\java\run1\Demo.java", "Java", 0, 0, 0, 20, 0, 1, 5, 26
"c:\workspace\research\papers\2024\JISBD2024-JAParejo\llms-design-patterns-evaluation\oodp-scenarios\structural\adapter\adapter-e2\src\main\java\run1\Peg.java", "Java", 0, 0, 0, 4, 0, 0, 3, 7
"c:\workspace\research\papers\2024\JISBD2024-JAParejo\llms-design-patterns-evaluation\oodp-scenarios\structural\adapter\adapter-e2\src\main\java\run1\RoundHole.java", "Java", 0, 0, 0, 16, 0, 0, 5, 21
"c:\workspace\research\papers\2024\JISBD2024-JAParejo\llms-design-patterns-evaluation\oodp-scenarios\structural\adapter\adapter-e2\src\main\java\run1\RoundPeg.java", "Java", 0, 0, 0, 17, 0, 0, 5, 22
"c:\workspace\research\papers\2024\JISBD2024-JAParejo\llms-design-patterns-evaluation\oodp-scenarios\structural\adapter\adapter-e2\src\main\java\run1\SquarePeg.java", "Java", 0, 0, 0, 13, 0, 0, 4, 17
"c:\workspace\research\papers\2024\JISBD2024-JAParejo\llms-design-patterns-evaluation\oodp-scenarios\structural\adapter\adapter-e2\src\main\java\run1\SquarePegAdapter.java", "Java", 0, 0, 0, 11, 0, 1, 4, 16
"c:\workspace\research\papers\2024\JISBD2024-JAParejo\llms-design-patterns-evaluation\oodp-scenarios\structural\adapter\adapter-e2\target\classes\original\Demo.class", "Java", 0, 0, 0, 11, 0, 0, 1, 12
"c:\workspace\research\papers\2024\JISBD2024-JAParejo\llms-design-patterns-evaluation\oodp-scenarios\structural\adapter\adapter-e2\target\classes\original\RoundHole.class", "Java", 0, 0, 0, 14, 0, 0, 0, 14
"c:\workspace\research\papers\2024\JISBD2024-JAParejo\llms-design-patterns-evaluation\oodp-scenarios\structural\adapter\adapter-e2\target\classes\original\RoundPeg.class", "Java", 0, 0, 0, 18, 0, 0, 1, 19
"c:\workspace\research\papers\2024\JISBD2024-JAParejo\llms-design-patterns-evaluation\oodp-scenarios\structural\adapter\adapter-e2\target\classes\original\SquarePeg.class", "Java", 0, 0, 0, 16, 0, 0, 1, 17
"c:\workspace\research\papers\2024\JISBD2024-JAParejo\llms-design-patterns-evaluation\oodp-scenarios\structural\adapter\adapter-e2\target\classes\run1\Demo.class", "Java", 0, 0, 0, 18, 0, 0, 0, 18
"c:\workspace\research\papers\2024\JISBD2024-JAParejo\llms-design-patterns-evaluation\oodp-scenarios\structural\adapter\adapter-e2\target\classes\run1\Peg.class", "Java", 0, 0, 0, 2, 0, 0, 0, 2
"c:\workspace\research\papers\2024\JISBD2024-JAParejo\llms-design-patterns-evaluation\oodp-scenarios\structural\adapter\adapter-e2\target\classes\run1\RoundHole.class", "Java", 0, 0, 0, 15, 0, 0, 0, 15
"c:\workspace\research\papers\2024\JISBD2024-JAParejo\llms-design-patterns-evaluation\oodp-scenarios\structural\adapter\adapter-e2\target\classes\run1\RoundPeg.class", "Java", 0, 0, 0, 14, 0, 0, 0, 14
"c:\workspace\research\papers\2024\JISBD2024-JAParejo\llms-design-patterns-evaluation\oodp-scenarios\structural\adapter\adapter-e2\target\classes\run1\SquarePeg.class", "Java", 0, 0, 0, 12, 0, 0, 0, 12
"c:\workspace\research\papers\2024\JISBD2024-JAParejo\llms-design-patterns-evaluation\oodp-scenarios\structural\adapter\adapter-e2\target\classes\run1\SquarePegAdapter.class", "Java", 0, 0, 0, 11, 0, 0, 0, 11
"c:\workspace\research\papers\2024\JISBD2024-JAParejo\llms-design-patterns-evaluation\oodp-scenarios\structural\adapter\adapter-e2\target\maven-archiver\pom.properties", "Java Properties", 0, 0, 0, 0, 3, 2, 1, 6
"c:\workspace\research\papers\2024\JISBD2024-JAParejo\llms-design-patterns-evaluation\oodp-scenarios\structural\decorator\decorator-e1\.mvn\wrapper\MavenWrapperDownloader.java", "Java", 0, 0, 0, 76, 0, 31, 11, 118
"c:\workspace\research\papers\2024\JISBD2024-JAParejo\llms-design-patterns-evaluation\oodp-scenarios\structural\decorator\decorator-e1\.mvn\wrapper\maven-wrapper.properties", "Java Properties", 0, 0, 0, 0, 2, 0, 1, 3
"c:\workspace\research\papers\2024\JISBD2024-JAParejo\llms-design-patterns-evaluation\oodp-scenarios\structural\decorator\decorator-e1\mvnw.cmd", "Batch", 0, 68, 0, 0, 0, 45, 32, 145
"c:\workspace\research\papers\2024\JISBD2024-JAParejo\llms-design-patterns-evaluation\oodp-scenarios\structural\decorator\decorator-e1\pom.xml", "XML", 19, 0, 0, 0, 0, 0, 5, 24
"c:\workspace\research\papers\2024\JISBD2024-JAParejo\llms-design-patterns-evaluation\oodp-scenarios\structural\decorator\decorator-e1\runs\run1.md", "Markdown", 0, 0, 96, 0, 0, 0, 38, 134
"c:\workspace\research\papers\2024\JISBD2024-JAParejo\llms-design-patterns-evaluation\oodp-scenarios\structural\decorator\decorator-e1\runs\run2.md", "Markdown", 0, 0, 85, 0, 0, 0, 36, 121
"c:\workspace\research\papers\2024\JISBD2024-JAParejo\llms-design-patterns-evaluation\oodp-scenarios\structural\decorator\decorator-e1\src\main\java\original\BubbleLights.java", "Java", 0, 0, 0, 9, 0, 0, 4, 13
"c:\workspace\research\papers\2024\JISBD2024-JAParejo\llms-design-patterns-evaluation\oodp-scenarios\structural\decorator\decorator-e1\src\main\java\original\ChristmasTree.java", "Java", 0, 0, 0, 9, 0, 0, 4, 13
"c:\workspace\research\papers\2024\JISBD2024-JAParejo\llms-design-patterns-evaluation\oodp-scenarios\structural\decorator\decorator-e1\src\main\java\original\Ornament.java", "Java", 0, 0, 0, 4, 0, 0, 2, 6
"c:\workspace\research\papers\2024\JISBD2024-JAParejo\llms-design-patterns-evaluation\oodp-scenarios\structural\decorator\decorator-e1\src\main\java\run1\BubbleLights.java", "Java", 0, 0, 0, 13, 0, 0, 4, 17
"c:\workspace\research\papers\2024\JISBD2024-JAParejo\llms-design-patterns-evaluation\oodp-scenarios\structural\decorator\decorator-e1\src\main\java\run1\ChristmasTree.java", "Java", 0, 0, 0, 7, 0, 0, 2, 9
"c:\workspace\research\papers\2024\JISBD2024-JAParejo\llms-design-patterns-evaluation\oodp-scenarios\structural\decorator\decorator-e1\src\main\java\run1\DecoratorDemo.java", "Java", 0, 0, 0, 9, 0, 0, 2, 11
"c:\workspace\research\papers\2024\JISBD2024-JAParejo\llms-design-patterns-evaluation\oodp-scenarios\structural\decorator\decorator-e1\src\main\java\run1\Ornament.java", "Java", 0, 0, 0, 4, 0, 0, 2, 6
"c:\workspace\research\papers\2024\JISBD2024-JAParejo\llms-design-patterns-evaluation\oodp-scenarios\structural\decorator\decorator-e1\src\main\java\run1\Tinsel.java", "Java", 0, 0, 0, 13, 0, 0, 4, 17
"c:\workspace\research\papers\2024\JISBD2024-JAParejo\llms-design-patterns-evaluation\oodp-scenarios\structural\decorator\decorator-e1\src\main\java\run1\TreeDecorator.java", "Java", 0, 0, 0, 10, 0, 0, 4, 14
"c:\workspace\research\papers\2024\JISBD2024-JAParejo\llms-design-patterns-evaluation\oodp-scenarios\structural\decorator\decorator-e1\src\main\java\run2\DecoratorDemo.java", "Java", 0, 0, 0, 12, 0, 0, 4, 16
"c:\workspace\research\papers\2024\JISBD2024-JAParejo\llms-design-patterns-evaluation\oodp-scenarios\structural\decorator\decorator-e1\src\main\java\run2\GarlandDecorator.java", "Java", 0, 0, 0, 14, 0, 0, 6, 20
"c:\workspace\research\papers\2024\JISBD2024-JAParejo\llms-design-patterns-evaluation\oodp-scenarios\structural\decorator\decorator-e1\src\main\java\run2\OrnamentDecorator.java", "Java", 0, 0, 0, 11, 0, 1, 4, 16
"c:\workspace\research\papers\2024\JISBD2024-JAParejo\llms-design-patterns-evaluation\oodp-scenarios\structural\decorator\decorator-e1\src\main\java\run2\TinselDecorator.java", "Java", 0, 0, 0, 14, 0, 0, 6, 20
"c:\workspace\research\papers\2024\JISBD2024-JAParejo\llms-design-patterns-evaluation\oodp-scenarios\structural\decorator\decorator-e1\target\classes\original\BubbleLights.class", "Java", 0, 0, 0, 9, 0, 0, 0, 9
"c:\workspace\research\papers\2024\JISBD2024-JAParejo\llms-design-patterns-evaluation\oodp-scenarios\structural\decorator\decorator-e1\target\classes\original\ChristmasTree.class", "Java", 0, 0, 0, 7, 0, 0, 0, 7
"c:\workspace\research\papers\2024\JISBD2024-JAParejo\llms-design-patterns-evaluation\oodp-scenarios\structural\decorator\decorator-e1\target\classes\original\Ornament.class", "Java", 0, 0, 0, 3, 0, 0, 0, 3
"c:\workspace\research\papers\2024\JISBD2024-JAParejo\llms-design-patterns-evaluation\oodp-scenarios\structural\decorator\decorator-e1\target\classes\run1\BubbleLights.class", "Java", 0, 0, 0, 16, 0, 0, 0, 16
"c:\workspace\research\papers\2024\JISBD2024-JAParejo\llms-design-patterns-evaluation\oodp-scenarios\structural\decorator\decorator-e1\target\classes\run1\ChristmasTree.class", "Java", 0, 0, 0, 7, 0, 0, 0, 7
"c:\workspace\research\papers\2024\JISBD2024-JAParejo\llms-design-patterns-evaluation\oodp-scenarios\structural\decorator\decorator-e1\target\classes\run1\DecoratorDemo.class", "Java", 0, 0, 0, 12, 0, 0, 0, 12
"c:\workspace\research\papers\2024\JISBD2024-JAParejo\llms-design-patterns-evaluation\oodp-scenarios\structural\decorator\decorator-e1\target\classes\run1\Ornament.class", "Java", 0, 0, 0, 4, 0, 0, 0, 4
"c:\workspace\research\papers\2024\JISBD2024-JAParejo\llms-design-patterns-evaluation\oodp-scenarios\structural\decorator\decorator-e1\target\classes\run1\Tinsel.class", "Java", 0, 0, 0, 17, 0, 0, 0, 17
"c:\workspace\research\papers\2024\JISBD2024-JAParejo\llms-design-patterns-evaluation\oodp-scenarios\structural\decorator\decorator-e1\target\classes\run1\TreeDecorator.class", "Java", 0, 0, 0, 12, 0, 0, 0, 12
"c:\workspace\research\papers\2024\JISBD2024-JAParejo\llms-design-patterns-evaluation\oodp-scenarios\structural\decorator\decorator-e1\target\classes\run2\DecoratorDemo.class", "Java", 0, 0, 0, 13, 0, 0, 0, 13
"c:\workspace\research\papers\2024\JISBD2024-JAParejo\llms-design-patterns-evaluation\oodp-scenarios\structural\decorator\decorator-e1\target\classes\run2\GarlandDecorator.class", "Java", 0, 0, 0, 16, 0, 0, 0, 16
"c:\workspace\research\papers\2024\JISBD2024-JAParejo\llms-design-patterns-evaluation\oodp-scenarios\structural\decorator\decorator-e1\target\classes\run2\OrnamentDecorator.class", "Java", 0, 0, 0, 11, 0, 0, 0, 11
"c:\workspace\research\papers\2024\JISBD2024-JAParejo\llms-design-patterns-evaluation\oodp-scenarios\structural\decorator\decorator-e1\target\classes\run2\TinselDecorator.class", "Java", 0, 0, 0, 15, 0, 0, 0, 15
"c:\workspace\research\papers\2024\JISBD2024-JAParejo\llms-design-patterns-evaluation\oodp-scenarios\structural\decorator\decorator-e1\target\maven-archiver\pom.properties", "Java Properties", 0, 0, 0, 0, 3, 2, 1, 6
"c:\workspace\research\papers\2024\JISBD2024-JAParejo\llms-design-patterns-evaluation\oodp-scenarios\structural\decorator\decorator-e2\.mvn\wrapper\MavenWrapperDownloader.java", "Java", 0, 0, 0, 76, 0, 31, 11, 118
"c:\workspace\research\papers\2024\JISBD2024-JAParejo\llms-design-patterns-evaluation\oodp-scenarios\structural\decorator\decorator-e2\.mvn\wrapper\maven-wrapper.properties", "Java Properties", 0, 0, 0, 0, 2, 0, 1, 3
"c:\workspace\research\papers\2024\JISBD2024-JAParejo\llms-design-patterns-evaluation\oodp-scenarios\structural\decorator\decorator-e2\mvnw.cmd", "Batch", 0, 68, 0, 0, 0, 45, 32, 145
"c:\workspace\research\papers\2024\JISBD2024-JAParejo\llms-design-patterns-evaluation\oodp-scenarios\structural\decorator\decorator-e2\pom.xml", "XML", 19, 0, 0, 0, 0, 0, 5, 24
"c:\workspace\research\papers\2024\JISBD2024-JAParejo\llms-design-patterns-evaluation\oodp-scenarios\structural\decorator\decorator-e2\runs\run1.md", "Markdown", 0, 0, 478, 0, 0, 0, 150, 628
"c:\workspace\research\papers\2024\JISBD2024-JAParejo\llms-design-patterns-evaluation\oodp-scenarios\structural\decorator\decorator-e2\runs\run2.md", "Markdown", 0, 0, 314, 0, 0, 0, 98, 412
"c:\workspace\research\papers\2024\JISBD2024-JAParejo\llms-design-patterns-evaluation\oodp-scenarios\structural\decorator\decorator-e2\src\main\java\original\DataSource.java", "Java", 0, 0, 0, 5, 0, 0, 2, 7
"c:\workspace\research\papers\2024\JISBD2024-JAParejo\llms-design-patterns-evaluation\oodp-scenarios\structural\decorator\decorator-e2\src\main\java\original\FileDataSource.java", "Java", 0, 0, 0, 32, 0, 1, 6, 39
"c:\workspace\research\papers\2024\JISBD2024-JAParejo\llms-design-patterns-evaluation\oodp-scenarios\structural\decorator\decorator-e2\src\main\java\run1\CompressionDecorator.java", "Java", 0, 0, 0, 24, 0, 2, 5, 31
"c:\workspace\research\papers\2024\JISBD2024-JAParejo\llms-design-patterns-evaluation\oodp-scenarios\structural\decorator\decorator-e2\src\main\java\run1\CompressionDecorator2.java", "Java", 0, 0, 0, 22, 0, 2, 6, 30
"c:\workspace\research\papers\2024\JISBD2024-JAParejo\llms-design-patterns-evaluation\oodp-scenarios\structural\decorator\decorator-e2\src\main\java\run1\CompressionDecorator3.java", "Java", 0, 0, 0, 22, 0, 4, 5, 31
"c:\workspace\research\papers\2024\JISBD2024-JAParejo\llms-design-patterns-evaluation\oodp-scenarios\structural\decorator\decorator-e2\src\main\java\run1\DataSource.java", "Java", 0, 0, 0, 5, 0, 0, 2, 7
"c:\workspace\research\papers\2024\JISBD2024-JAParejo\llms-design-patterns-evaluation\oodp-scenarios\structural\decorator\decorator-e2\src\main\java\run1\DataSourceDecorator.java", "Java", 0, 0, 0, 7, 0, 0, 3, 10
"c:\workspace\research\papers\2024\JISBD2024-JAParejo\llms-design-patterns-evaluation\oodp-scenarios\structural\decorator\decorator-e2\src\main\java\run1\DataSourceDecorator2.java", "Java", 0, 0, 0, 15, 0, 0, 5, 20
"c:\workspace\research\papers\2024\JISBD2024-JAParejo\llms-design-patterns-evaluation\oodp-scenarios\structural\decorator\decorator-e2\src\main\java\run1\DecoratorDemo.java", "Java", 0, 0, 0, 12, 0, 1, 5, 18
"c:\workspace\research\papers\2024\JISBD2024-JAParejo\llms-design-patterns-evaluation\oodp-scenarios\structural\decorator\decorator-e2\src\main\java\run1\DecoratorDemo2.java", "Java", 0, 0, 0, 12, 0, 1, 5, 18
"c:\workspace\research\papers\2024\JISBD2024-JAParejo\llms-design-patterns-evaluation\oodp-scenarios\structural\decorator\decorator-e2\src\main\java\run1\EncryptionDecorator.java", "Java", 0, 0, 0, 20, 0, 2, 5, 27
"c:\workspace\research\papers\2024\JISBD2024-JAParejo\llms-design-patterns-evaluation\oodp-scenarios\structural\decorator\decorator-e2\src\main\java\run1\EncryptionDecorator2.java", "Java", 0, 0, 0, 26, 0, 2, 6, 34
"c:\workspace\research\papers\2024\JISBD2024-JAParejo\llms-design-patterns-evaluation\oodp-scenarios\structural\decorator\decorator-e2\src\main\java\run1\EncryptionDecorator3.java", "Java", 0, 0, 0, 22, 0, 4, 6, 32
"c:\workspace\research\papers\2024\JISBD2024-JAParejo\llms-design-patterns-evaluation\oodp-scenarios\structural\decorator\decorator-e2\src\main\java\run1\FileDataSource.java", "Java", 0, 0, 0, 33, 0, 0, 6, 39
"c:\workspace\research\papers\2024\JISBD2024-JAParejo\llms-design-patterns-evaluation\oodp-scenarios\structural\decorator\decorator-e2\src\main\java\run2\CompressionDecorator.java", "Java", 0, 0, 0, 24, 0, 2, 5, 31
"c:\workspace\research\papers\2024\JISBD2024-JAParejo\llms-design-patterns-evaluation\oodp-scenarios\structural\decorator\decorator-e2\src\main\java\run2\CompressionDecorator2.java", "Java", 0, 0, 0, 22, 0, 2, 6, 30
"c:\workspace\research\papers\2024\JISBD2024-JAParejo\llms-design-patterns-evaluation\oodp-scenarios\structural\decorator\decorator-e2\src\main\java\run2\CompressionDecorator3.java", "Java", 0, 0, 0, 22, 0, 4, 5, 31
"c:\workspace\research\papers\2024\JISBD2024-JAParejo\llms-design-patterns-evaluation\oodp-scenarios\structural\decorator\decorator-e2\src\main\java\run2\DataSource.java", "Java", 0, 0, 0, 5, 0, 0, 2, 7
"c:\workspace\research\papers\2024\JISBD2024-JAParejo\llms-design-patterns-evaluation\oodp-scenarios\structural\decorator\decorator-e2\src\main\java\run2\DataSourceDecorator.java", "Java", 0, 0, 0, 7, 0, 0, 3, 10
"c:\workspace\research\papers\2024\JISBD2024-JAParejo\llms-design-patterns-evaluation\oodp-scenarios\structural\decorator\decorator-e2\src\main\java\run2\DataSourceDecorator2.java", "Java", 0, 0, 0, 15, 0, 0, 5, 20
"c:\workspace\research\papers\2024\JISBD2024-JAParejo\llms-design-patterns-evaluation\oodp-scenarios\structural\decorator\decorator-e2\src\main\java\run2\DecoratorDemo.java", "Java", 0, 0, 0, 12, 0, 1, 5, 18
"c:\workspace\research\papers\2024\JISBD2024-JAParejo\llms-design-patterns-evaluation\oodp-scenarios\structural\decorator\decorator-e2\src\main\java\run2\DecoratorDemo2.java", "Java", 0, 0, 0, 12, 0, 1, 5, 18
"c:\workspace\research\papers\2024\JISBD2024-JAParejo\llms-design-patterns-evaluation\oodp-scenarios\structural\decorator\decorator-e2\src\main\java\run2\EncryptionDecorator.java", "Java", 0, 0, 0, 20, 0, 2, 5, 27
"c:\workspace\research\papers\2024\JISBD2024-JAParejo\llms-design-patterns-evaluation\oodp-scenarios\structural\decorator\decorator-e2\src\main\java\run2\EncryptionDecorator2.java", "Java", 0, 0, 0, 26, 0, 2, 6, 34
"c:\workspace\research\papers\2024\JISBD2024-JAParejo\llms-design-patterns-evaluation\oodp-scenarios\structural\decorator\decorator-e2\src\main\java\run2\EncryptionDecorator3.java", "Java", 0, 0, 0, 22, 0, 4, 6, 32
"c:\workspace\research\papers\2024\JISBD2024-JAParejo\llms-design-patterns-evaluation\oodp-scenarios\structural\decorator\decorator-e2\src\main\java\run2\FileDataSource.java", "Java", 0, 0, 0, 33, 0, 0, 6, 39
"c:\workspace\research\papers\2024\JISBD2024-JAParejo\llms-design-patterns-evaluation\oodp-scenarios\structural\decorator\decorator-e2\target\classes\original\DataSource.class", "Java", 0, 0, 0, 2, 0, 0, 1, 3
"c:\workspace\research\papers\2024\JISBD2024-JAParejo\llms-design-patterns-evaluation\oodp-scenarios\structural\decorator\decorator-e2\target\classes\original\FileDataSource.class", "Java", 0, 0, 0, 29, 0, 0, 1, 30
"c:\workspace\research\papers\2024\JISBD2024-JAParejo\llms-design-patterns-evaluation\oodp-scenarios\structural\decorator\decorator-e2\target\classes\run1\CompressionDecorator.class", "Java", 0, 0, 0, 33, 0, 0, 1, 34
"c:\workspace\research\papers\2024\JISBD2024-JAParejo\llms-design-patterns-evaluation\oodp-scenarios\structural\decorator\decorator-e2\target\classes\run1\CompressionDecorator2.class", "Java", 0, 0, 0, 24, 0, 0, 1, 25
"c:\workspace\research\papers\2024\JISBD2024-JAParejo\llms-design-patterns-evaluation\oodp-scenarios\structural\decorator\decorator-e2\target\classes\run1\CompressionDecorator3.class", "Java", 0, 0, 0, 22, 0, 0, 0, 22
"c:\workspace\research\papers\2024\JISBD2024-JAParejo\llms-design-patterns-evaluation\oodp-scenarios\structural\decorator\decorator-e2\target\classes\run1\DataSource.class", "Java", 0, 0, 0, 2, 0, 0, 1, 3
"c:\workspace\research\papers\2024\JISBD2024-JAParejo\llms-design-patterns-evaluation\oodp-scenarios\structural\decorator\decorator-e2\target\classes\run1\DataSourceDecorator.class", "Java", 0, 0, 0, 9, 0, 0, 0, 9
"c:\workspace\research\papers\2024\JISBD2024-JAParejo\llms-design-patterns-evaluation\oodp-scenarios\structural\decorator\decorator-e2\target\classes\run1\DataSourceDecorator2.class", "Java", 0, 0, 0, 14, 0, 0, 0, 14
"c:\workspace\research\papers\2024\JISBD2024-JAParejo\llms-design-patterns-evaluation\oodp-scenarios\structural\decorator\decorator-e2\target\classes\run1\DecoratorDemo.class", "Java", 0, 0, 0, 18, 0, 0, 0, 18
"c:\workspace\research\papers\2024\JISBD2024-JAParejo\llms-design-patterns-evaluation\oodp-scenarios\structural\decorator\decorator-e2\target\classes\run1\DecoratorDemo2.class", "Java", 0, 0, 0, 18, 0, 0, 0, 18
"c:\workspace\research\papers\2024\JISBD2024-JAParejo\llms-design-patterns-evaluation\oodp-scenarios\structural\decorator\decorator-e2\target\classes\run1\EncryptionDecorator.class", "Java", 0, 0, 0, 27, 0, 0, 1, 28
"c:\workspace\research\papers\2024\JISBD2024-JAParejo\llms-design-patterns-evaluation\oodp-scenarios\structural\decorator\decorator-e2\target\classes\run1\EncryptionDecorator2.class", "Java", 0, 0, 0, 34, 0, 0, 1, 35
"c:\workspace\research\papers\2024\JISBD2024-JAParejo\llms-design-patterns-evaluation\oodp-scenarios\structural\decorator\decorator-e2\target\classes\run1\EncryptionDecorator3.class", "Java", 0, 0, 0, 25, 0, 0, 0, 25
"c:\workspace\research\papers\2024\JISBD2024-JAParejo\llms-design-patterns-evaluation\oodp-scenarios\structural\decorator\decorator-e2\target\classes\run1\FileDataSource.class", "Java", 0, 0, 0, 32, 0, 0, 1, 33
"c:\workspace\research\papers\2024\JISBD2024-JAParejo\llms-design-patterns-evaluation\oodp-scenarios\structural\decorator\decorator-e2\target\classes\run2\CompressionDecorator.class", "Java", 0, 0, 0, 33, 0, 0, 1, 34
"c:\workspace\research\papers\2024\JISBD2024-JAParejo\llms-design-patterns-evaluation\oodp-scenarios\structural\decorator\decorator-e2\target\classes\run2\CompressionDecorator2.class", "Java", 0, 0, 0, 24, 0, 0, 1, 25
"c:\workspace\research\papers\2024\JISBD2024-JAParejo\llms-design-patterns-evaluation\oodp-scenarios\structural\decorator\decorator-e2\target\classes\run2\CompressionDecorator3.class", "Java", 0, 0, 0, 22, 0, 0, 0, 22
"c:\workspace\research\papers\2024\JISBD2024-JAParejo\llms-design-patterns-evaluation\oodp-scenarios\structural\decorator\decorator-e2\target\classes\run2\DataSource.class", "Java", 0, 0, 0, 2, 0, 0, 1, 3
"c:\workspace\research\papers\2024\JISBD2024-JAParejo\llms-design-patterns-evaluation\oodp-scenarios\structural\decorator\decorator-e2\target\classes\run2\DataSourceDecorator.class", "Java", 0, 0, 0, 9, 0, 0, 0, 9
"c:\workspace\research\papers\2024\JISBD2024-JAParejo\llms-design-patterns-evaluation\oodp-scenarios\structural\decorator\decorator-e2\target\classes\run2\DataSourceDecorator2.class", "Java", 0, 0, 0, 14, 0, 0, 0, 14
"c:\workspace\research\papers\2024\JISBD2024-JAParejo\llms-design-patterns-evaluation\oodp-scenarios\structural\decorator\decorator-e2\target\classes\run2\DecoratorDemo.class", "Java", 0, 0, 0, 18, 0, 0, 0, 18
"c:\workspace\research\papers\2024\JISBD2024-JAParejo\llms-design-patterns-evaluation\oodp-scenarios\structural\decorator\decorator-e2\target\classes\run2\DecoratorDemo2.class", "Java", 0, 0, 0, 18, 0, 0, 0, 18
"c:\workspace\research\papers\2024\JISBD2024-JAParejo\llms-design-patterns-evaluation\oodp-scenarios\structural\decorator\decorator-e2\target\classes\run2\EncryptionDecorator.class", "Java", 0, 0, 0, 27, 0, 0, 1, 28
"c:\workspace\research\papers\2024\JISBD2024-JAParejo\llms-design-patterns-evaluation\oodp-scenarios\structural\decorator\decorator-e2\target\classes\run2\EncryptionDecorator2.class", "Java", 0, 0, 0, 34, 0, 0, 1, 35
"c:\workspace\research\papers\2024\JISBD2024-JAParejo\llms-design-patterns-evaluation\oodp-scenarios\structural\decorator\decorator-e2\target\classes\run2\EncryptionDecorator3.class", "Java", 0, 0, 0, 25, 0, 0, 0, 25
"c:\workspace\research\papers\2024\JISBD2024-JAParejo\llms-design-patterns-evaluation\oodp-scenarios\structural\decorator\decorator-e2\target\classes\run2\FileDataSource.class", "Java", 0, 0, 0, 32, 0, 0, 1, 33
"c:\workspace\research\papers\2024\JISBD2024-JAParejo\llms-design-patterns-evaluation\oodp-scenarios\structural\decorator\decorator-e2\target\maven-archiver\pom.properties", "Java Properties", 0, 0, 0, 0, 3, 2, 1, 6
"Total", "-", 254, 884, 7173, 8074, 60, 1247, 4077, 21769